SRNO,REGIONAL CENTRE,AI-CODE AND NAME,TOTAL STUDENTS UPLOADED TMA,TOTAL TMA UPLOADED,TOTAL ALLOCATED SUBJECTS,TOTAL UN-ALLOCATED SUBJECTS,TOTAL EVALUATED SUBJECTS,TOTAL ALLOCATED UN-EVALUATED SUBJECTS,PRE-ALLOCATED,PRE-EVALUATED
1,118-GANDHINAGAR,M04020-Noori Higher Secondary School - Dhrol,490,2827,2827,0,2315,512,100,81.89
2,118-GANDHINAGAR,"M39049-Noori Higher Secondary School,",496,2798,2798,0,2797,1,100,99.96
3,118-GANDHINAGAR,390102-Navyug Vidyalaya,489,2708,2708,0,2542,166,100,93.87
4,109-JAIPUR,170121-Saraswati Vidya Mandir Senior,465,2407,2407,0,2407,0,100,100
5,106-KOCHI,M09040-Crescent Rsidential Higher,504,2325,2323,2,2194,129,99.91,94.37
6,113-BHOPAL,100048-Pragya Higher Secondary School,531,2272,2261,11,2163,98,99.52,95.2
7,109-JAIPUR,170147-Friends Public Sr.sec. School,421,2101,2092,9,2017,75,99.57,96
8,104-GUWAHATI,240003-Govt.higher Secondary School,404,2069,2068,1,2063,5,99.95,99.71
9,106-KOCHI,M09001-Jdt Islam Orphanage,430,2011,2011,0,2007,4,100,99.8
10,104-GUWAHATI,240001-Govt. Hr. Sec. School,390,1983,1983,0,1392,591,100,70.2
11,104-GUWAHATI,240010-Govt. Higher Sec. School,422,1980,1979,1,1945,34,99.95,98.23
12,103-KOLKATA,460523-Baidyapara High School,400,1968,1961,7,1961,0,99.64,99.64
13,118-GANDHINAGAR,"M38147-Noori Higher Secondary School,",426,1940,1940,0,1841,99,100,94.9
14,103-KOLKATA,460529-Netaji Subhas DAV Public School,355,1938,1938,0,1938,0,100,100
15,109-JAIPUR,170342-Saraswati Adarsh Sr.sec. School,379,1919,1919,0,1919,0,100,100
16,103-KOLKATA,220119-Netaji Subhas DAV Public School,342,1895,1895,0,1895,0,100,100
17,104-GUWAHATI,120018-Royal Academy,423,1832,1832,0,1750,82,100,95.52
18,118-GANDHINAGAR,390155-Shree Swaminarayan Gurukul School,296,1777,1777,0,1483,294,100,83.46
19,109-JAIPUR,170132-Hans International Sr.sec.school,353,1753,1750,3,1750,0,99.83,99.83
20,105-CHANDIGARH,250004-D A V Sr.sec. School,376,1700,1691,9,1691,0,99.47,99.47
21,104-GUWAHATI,300002-Govt. Bungkawn High School,414,1667,1667,0,1645,22,100,98.68
22,103-KOLKATA,M22074-Anglo Arabic Secondary School,367,1647,1642,5,1637,5,99.7,99.39
23,104-GUWAHATI,200001-Shishu Bihar Higher Sec. School,322,1633,1622,11,1032,590,99.33,63.2
24,106-KOCHI,090082-Kendriya Vidyalaya,342,1633,1633,0,1009,624,100,61.79
25,104-GUWAHATI,240006-Govt. Hr. Sec. School,332,1611,1607,4,1181,426,99.75,73.31
26,104-GUWAHATI,020009-Gohpur Higher Sec. School,349,1590,1586,4,1442,144,99.75,90.69
27,104-GUWAHATI,M02073-Lakshirbond Higher Secondary Madarsa,345,1462,1462,0,1459,3,100,99.79
28,114-DEHRADUN,M38300-Makhdoom Baksh Jamia Islamia,241,1440,1440,0,1440,0,100,100
29,103-KOLKATA,220099-Jawahar Navodaya Vidyalaya,260,1440,1439,1,1439,0,99.93,99.93
30,103-KOLKATA,460510-Dariapur Imampur Barambol High Sch,287,1439,0,1439,0,0,0,0
31,106-KOCHI,090045-Kendriya Vidyalaya,302,1410,1409,1,1409,0,99.93,99.93
32,103-KOLKATA,460528-Gitanjali Public School,254,1399,1399,0,1280,119,100,91.49
33,104-GUWAHATI,240021-Kendriya Vidyalaya,252,1377,1376,1,1367,9,99.93,99.27
34,106-KOCHI,M09006-Ansar English School,277,1369,1369,0,978,391,100,71.44
35,109-JAIPUR,170113-Mahala Residential Public School,265,1368,1368,0,936,432,100,68.42
36,118-GANDHINAGAR,390116-Shree Sharda Secondary & High. Secondary School,266,1307,1307,0,1042,265,100,79.72
37,103-KOLKATA,220116-Dreamland School,253,1304,1304,0,1231,73,100,94.4
38,106-KOCHI,090081-Kendriya Vidyalaya,278,1303,1303,0,1303,0,100,100
39,109-JAIPUR,170365-Shri Imrat Senior Secondary School,268,1300,1300,0,1299,1,100,99.92
40,107-DELHI,"450061-Akshya Pratisthan,",271,1294,1294,0,1294,0,100,100
41,118-GANDHINAGAR,390083-Nib School Of Science,222,1274,1271,3,1184,87,99.76,92.94
42,106-KOCHI,090035-Sree Valluvanad Vidya Bhavan,271,1272,1270,2,1228,42,99.84,96.54
43,106-KOCHI,090047-Kendriya Vidyalaya,273,1263,1260,3,1225,35,99.76,96.99
44,106-KOCHI,"M09060-M.t.i Central School Pottachira,",263,1262,1262,0,915,347,100,72.5
45,107-DELHI,270433-Chand Ram Public School,262,1245,1241,4,1240,1,99.68,99.6
46,109-JAIPUR,170309-Marwar Winners Public Sr.sec.school,268,1245,1245,0,1245,0,100,100
47,106-KOCHI,090027-Darussalam Eng. School,259,1231,1231,0,264,967,100,21.45
48,109-JAIPUR,170105-Global Career Sr.sec. School,267,1222,1222,0,1222,0,100,100
49,109-JAIPUR,170374-Saraswti Bal Niketan Sr.Sec. School,276,1198,1188,10,1185,3,99.17,98.91
50,118-GANDHINAGAR,380281-Saraswat International Academy,245,1195,1195,0,1192,3,100,99.75
51,109-JAIPUR,170102-Swami Nityanand Sr.sec.school,243,1191,1191,0,1191,0,100,100
52,109-JAIPUR,170444-Shri Ram Sr. Sec. School,288,1189,1189,0,1189,0,100,100
53,104-GUWAHATI,140016-Mount Mary Academy,238,1178,1178,0,1119,59,100,94.99
54,104-GUWAHATI,240019-Kendriya Vidyalaya,230,1157,1157,0,1156,1,100,99.91
55,104-GUWAHATI,240017-Govt. Hr.sec.school,230,1151,1150,1,919,231,99.91,79.84
56,109-JAIPUR,170360-Marudhara Public Sr.Sec. School,255,1144,1144,0,1144,0,100,100
57,109-JAIPUR,170154-Govt. Sr. Sec. School,233,1138,1138,0,848,290,100,74.52
58,106-KOCHI,M09071-Islamic Central School,237,1137,1137,0,1029,108,100,90.5
59,109-JAIPUR,170287-Govt. Sr. Sec. School,246,1136,1136,0,956,180,100,84.15
60,109-JAIPUR,170191-Bhartiya Vidya Mandir Sr.sec.school,228,1135,1135,0,1125,10,100,99.12
61,106-KOCHI,090064-C.k.m.s.s. Sr. Secondary School,238,1130,1130,0,1118,12,100,98.94
62,107-DELHI,270405-ARUN MODERN PUBLIC SR.SEC.SCHOOL,244,1122,1113,9,1095,18,99.2,97.59
63,106-KOCHI,090058-Kendriya Vidyalaya,227,1095,1094,1,1094,0,99.91,99.91
64,109-JAIPUR,170051-Bal Vikas Adarsh Sr. Secondary School,243,1089,1089,0,1089,0,100,100
65,106-KOCHI,090034-Vyasa Vidya Peethom,220,1076,1076,0,917,159,100,85.22
66,104-GUWAHATI,020044-Kendriya Vidyalaya,257,1055,1032,23,715,317,97.82,67.77
67,118-GANDHINAGAR,390097-Om Shanti English Medium School,190,1042,1042,0,928,114,100,89.06
68,104-GUWAHATI,240020-Kendriya Vidyalaya,203,1027,1020,7,861,159,99.32,83.84
69,106-KOCHI,090015-Bhavan's Vidya Mandir,258,1012,1012,0,1004,8,100,99.21
70,103-KOLKATA,220114-Gitanjali Public School,195,1006,1006,0,948,58,100,94.23
71,107-DELHI,"270267-Career Public School,473",213,999,992,7,992,0,99.3,99.3
72,104-GUWAHATI,020027-Kendriya Vidyalaya,244,995,991,4,864,127,99.6,86.83
73,118-GANDHINAGAR,040127-Shree Swaminarayan Gurukul School,197,993,993,0,971,22,100,97.78
74,123-GANGTOK,450178-North Bengal Central School,197,993,993,0,984,9,100,99.09
75,107-DELHI,"M27191-IASE, FACULTY OF EDUCATION",216,986,981,5,793,188,99.49,80.43
76,117-BENGALURU,M38041-Al-ameen Educational Society,242,983,983,0,983,0,100,100
77,114-DEHRADUN,M34233-Makhdoom Baksh Jamia Islamia,168,979,979,0,979,0,100,100
78,109-JAIPUR,170446-Seven Star Convent School,211,963,963,0,963,0,100,100
79,103-KOLKATA,220037-The Assembly Of God Church School,219,962,923,39,848,75,95.95,88.15
80,123-GANGTOK,180005-Fiveways School,198,933,933,0,825,108,100,88.42
81,109-JAIPUR,170031-Rajasthan Public Sr.sec. School,183,929,929,0,929,0,100,100
82,102-PUNE,M38343-Maulana Abul Kalam  Azad Residential Urdu High School & Jr College,195,922,922,0,721,201,100,78.2
83,105-CHANDIGARH,050641-Sharde Public School,211,918,918,0,918,0,100,100
84,106-KOCHI,090039-Saraswati Vidya Nikethan Public,203,916,915,1,269,646,99.89,29.37
85,107-DELHI,270530-J N International School,192,894,894,0,152,742,100,17
86,106-KOCHI,M09108-Al Ameen English School,159,893,893,0,893,0,100,100
87,106-KOCHI,090048-Kendriya Vidyalaya,193,892,892,0,886,6,100,99.33
88,118-GANDHINAGAR,040068-Om Shanti English Medium School,188,890,890,0,608,282,100,68.31
89,107-DELHI,270489-Satyawati Sood Arya Girls Sr.Sec.,187,889,889,0,464,425,100,52.19
90,118-GANDHINAGAR,M39051-Razvi High School -  Lalpur,148,888,888,0,885,3,100,99.66
91,106-KOCHI,090054-Kendriya Vidyalaya,192,888,888,0,888,0,100,100
92,109-JAIPUR,M17260-St. Francis Sr.Sec. School,171,884,884,0,884,0,100,100
93,107-DELHI,270266-M. Savitri D.sanjeevani Pub School,179,878,871,7,847,24,99.2,96.47
94,109-JAIPUR,170298-Sunrise Public Sr.sec. School,185,876,876,0,844,32,100,96.35
95,118-GANDHINAGAR,390084-B.N. Zala Vidyalaya,147,876,876,0,749,127,100,85.5
96,118-GANDHINAGAR,390085-Maruti High School,157,874,874,0,820,54,100,93.82
97,106-KOCHI,090012-Travancore Inst.of Sci.& Technology,168,872,872,0,865,7,100,99.2
98,114-DEHRADUN,210622-Konark Vidyapeeth,174,868,868,0,866,2,100,99.77
99,107-DELHI,270226-Sarvodaya Bal Vidyalaya,179,862,10,852,0,10,1.16,0
100,109-JAIPUR,M17268-Madarsa Qadariya Faiz E Sikandriya,136,859,858,1,858,0,99.88,99.88
101,107-DELHI,270137-Dashmesh Public School,181,857,854,3,820,34,99.65,95.68
102,118-GANDHINAGAR,390103-D.H.K. Mungra Knaya Vidhyalay,149,856,856,0,713,143,100,83.29
103,109-JAIPUR,170284-Mother Land Shikshan Sansthan,168,849,849,0,757,92,100,89.16
104,104-GUWAHATI,240008-Govt. Hr. Sec. School,187,848,847,1,678,169,99.88,79.95
105,104-GUWAHATI,140013-H M C High School,179,846,846,0,523,323,100,61.82
106,107-DELHI,270454-Gyanodaya Sr. Sec. Public School,162,829,829,0,823,6,100,99.28
107,118-GANDHINAGAR,M39050-Jamia Ayesha Madarsatul Banat - Dhrol,146,829,829,0,828,1,100,99.88
108,117-BENGALURU,M08004-Al-Ameen Educational Society,174,828,828,0,827,1,100,99.88
109,109-JAIPUR,170411-Vinayak Vidhya Mandir Sr. Sec. School,166,816,816,0,816,0,100,100
110,118-GANDHINAGAR,390124-S S School of Science,162,815,815,0,751,64,100,92.15
111,107-DELHI,270542-Angels Public School,167,813,813,0,89,724,100,10.95
112,104-GUWAHATI,200020-Hapania High School,158,808,807,1,546,261,99.88,67.57
113,109-JAIPUR,170332-Shri Krishna Public Sr.sec. School,179,805,805,0,805,0,100,100
114,106-KOCHI,"090029-Progressive English School,",168,798,795,3,167,628,99.62,20.93
115,118-GANDHINAGAR,390095-Ochhavlal Sheth High School,161,791,791,0,744,47,100,94.06
116,107-DELHI,270106-Fr. Agnel School,181,790,788,2,520,268,99.75,65.82
117,104-GUWAHATI,240027-Govt. Secondary School,165,789,788,1,777,11,99.87,98.48
118,105-CHANDIGARH,160106-Rajindra Sr.Sec. Public School,145,788,788,0,788,0,100,100
119,114-DEHRADUN,340253-Banjarawala Dehra Public,169,783,783,0,783,0,100,100
120,107-DELHI,270459-J.B.M. Public School,164,756,750,6,700,50,99.21,92.59
121,107-DELHI,270172-Govt. Boys Sr.secondary School,160,754,740,14,532,208,98.14,70.56
122,118-GANDHINAGAR,040059-B.n. Zala Vidyalaya,148,753,753,0,736,17,100,97.74
123,107-DELHI,050651-S D Public School,175,753,749,4,0,749,99.47,0
124,107-DELHI,M27477-Victoria Public Sr.sec. School,157,753,685,68,420,265,90.97,55.78
125,102-PUNE,280007-Shree Ram High School,150,743,741,2,740,1,99.73,99.6
126,107-DELHI,270529-Sant Gyaneshwar Model School,150,740,740,0,635,105,100,85.81
127,105-CHANDIGARH,050607-RISHIKUL SR. SEC. SCHOOL,169,739,739,0,739,0,100,100
128,104-GUWAHATI,300009-Govt. S. Himem High School,182,729,728,1,695,33,99.86,95.34
129,123-GANGTOK,220015-Marwari Panchayat Charity Trust,158,728,652,76,650,2,89.56,89.29
130,106-KOCHI,M09059-Markazul Uloom English School,169,724,724,0,724,0,100,100
131,106-KOCHI,090002-M E S Women's College,158,710,710,0,684,26,100,96.34
132,107-DELHI,270318-Saai Memorial Girls School,151,706,706,0,688,18,100,97.45
133,107-DELHI,270416-G.d Lancer's Public School,150,704,699,5,699,0,99.29,99.29
134,109-JAIPUR,170145-Mahima Bal Bharti Sr.sec.school,126,699,699,0,699,0,100,100
135,115-BHUBANESWAR,"150181-Government High School, koraput",119,698,356,342,286,70,51,40.97
136,123-GANGTOK,220041-Vidyasagar Higher Secondary School,133,696,678,18,539,139,97.41,77.44
137,107-DELHI,270406-M.R.L. Senior Secondary School,149,696,696,0,450,246,100,64.66
138,118-GANDHINAGAR,M04021-Razvi High School - Lalpur,141,695,695,0,690,5,100,99.28
139,115-BHUBANESWAR,454101-SRUSTI (Society For Rural Upliftment & Socio  Technological Initiative),123,691,691,0,680,11,100,98.41
140,107-DELHI,270472-Kasturba Balika Vidyalaya,145,691,691,0,691,0,100,100
141,104-GUWAHATI,130019-Jawahar Navodaya Vidyalaya,140,688,686,2,403,283,99.71,58.58
142,118-GANDHINAGAR,390092-Saraswati Vidya Mandir,124,688,688,0,683,5,100,99.27
143,109-JAIPUR,170420-Yogyata Vihar Sr. Sec. School,153,686,686,0,686,0,100,100
144,106-KOCHI,090053-Vidyadhiraja Vidyapeetom Central,134,686,686,0,685,1,100,99.85
145,109-JAIPUR,170445-Choudhary Public Sr. Sec. School,148,681,681,0,679,2,100,99.71
146,114-DEHRADUN,340168-Shivedale School,138,670,670,0,670,0,100,100
147,109-JAIPUR,M17215-Maulana Abul Kalam Azad Muslim,135,670,670,0,670,0,100,100
148,107-DELHI,270539-M D Indraprastha Public School,140,662,652,10,649,3,98.49,98.04
149,107-DELHI,270101-ROHTAGI A V SR.SEC.SCHOOL,138,656,655,1,655,0,99.85,99.85
150,106-KOCHI,090078-Janasakthi Public School,143,655,655,0,416,239,100,63.51
151,103-KOLKATA,220128-Mount Litera Zee School,127,654,0,654,0,0,0,0
152,104-GUWAHATI,M02074-Gyan Jyoti Higher Secondary School,149,653,653,0,630,23,100,96.48
153,109-JAIPUR,170382-Sh. Jagdamba Sr. Sec. School,140,652,652,0,652,0,100,100
154,107-DELHI,270483-The Vivekanand School,138,650,639,11,587,52,98.31,90.31
155,105-CHANDIGARH,050533-Vishva Bharti Public School,149,650,649,1,522,127,99.85,80.31
156,105-CHANDIGARH,250002-Jan Shiksha Sansthan,141,649,645,4,616,29,99.38,94.92
157,118-GANDHINAGAR,390100-Sh. Galteshwar Mahadev Hr.Sec.Sch,131,647,647,0,646,1,100,99.85
158,103-KOLKATA,460530-Swami Vivekananda Vidyamandir,129,646,642,4,471,171,99.38,72.91
159,107-DELHI,270128-Kendriya Vidyalaya,138,646,634,12,500,134,98.14,77.4
160,107-DELHI,M21307-Assisi Convent School,135,643,0,643,0,0,0,0
161,105-CHANDIGARH,"M25012-St. Josephs Sr. Sec. School,",141,637,633,4,633,0,99.37,99.37
162,106-KOCHI,090055-Kendriya Vidyalaya,130,636,636,0,626,10,100,98.43
163,106-KOCHI,M09091-Aliya Senior Secondary School,135,634,633,1,293,340,99.84,46.21
164,109-JAIPUR,170122-Indian Public Sr.Sec.school,139,634,634,0,632,2,100,99.68
165,123-GANGTOK,180003-Govt. Senior Secondary School,136,632,632,0,632,0,100,100
166,104-GUWAHATI,M46002-LAKSHIRBOND HIGHER SECONDARY MADARSSA,155,627,627,0,627,0,100,100
167,106-KOCHI,M09092-Infant Jesus Residential School,128,622,622,0,610,12,100,98.07
168,103-KOLKATA,220109-Kendriya Vidyalaya,127,621,298,323,0,298,47.99,0
169,109-JAIPUR,170283-Bhartiya Shikshan Sansthan Senior,134,620,620,0,620,0,100,100
170,107-DELHI,050621-S R S International School,139,609,603,6,602,1,99.01,98.85
171,107-DELHI,050579-Colonel's Public School,124,605,605,0,516,89,100,85.29
172,107-DELHI,270224-Cosmos Public School,130,605,467,138,0,467,77.19,0
173,109-JAIPUR,170341-Ramsnehi Sr.sec. School,120,604,598,6,598,0,99.01,99.01
174,106-KOCHI,090036-Sree Saraswathy Vidya Mandir,129,604,604,0,604,0,100,100
175,105-CHANDIGARH,050563-AISHLY PUBLIC SCHOOL,128,600,600,0,519,81,100,86.5
176,107-DELHI,270134-Kautilya Govt Sarvodaya Bal,120,600,0,600,0,0,0,0
177,107-DELHI,270495-Harcourt Butler Sr. Sec. School,122,597,585,12,582,3,97.99,97.49
178,105-CHANDIGARH,050311-Suraj Senior Secondary School,120,597,597,0,597,0,100,100
179,105-CHANDIGARH,050529-Aastha International Public School,136,591,591,0,581,10,100,98.31
180,106-KOCHI,090026-Sree Vivekananda Higher Sec. School,125,589,589,0,578,11,100,98.13
181,104-GUWAHATI,140012-St. Joseph's School,119,589,589,0,589,0,100,100
182,109-JAIPUR,170404-BHAGAT SINGH SR. SEC. SCHOOL,108,588,588,0,291,297,100,49.49
183,107-DELHI,270516-St. Kabir Modern School,131,587,579,8,579,0,98.64,98.64
184,109-JAIPUR,170351-Subhash Public Sr.Sec. School,130,586,586,0,586,0,100,100
185,114-DEHRADUN,210467-Sarvodaya Public School,119,579,579,0,579,0,100,100
186,107-DELHI,270205-Seth Bhagwandass Sr.sec.school,132,578,0,578,0,0,0,0
187,107-DELHI,210198-Bloom Public School,124,578,159,419,85,74,27.51,14.71
188,106-KOCHI,M09085-Mao Higher Secondary School Elayur,139,574,574,0,574,0,100,100
189,103-KOLKATA,M46001-St. Augustine's Day School,123,574,0,574,0,0,0,0
190,107-DELHI,270115-Govt. Boys Sr. Sec. School No.-1,122,570,0,570,0,0,0,0
191,106-KOCHI,090049-Kendriya Vidyalaya No-2,111,567,567,0,567,0,100,100
192,109-JAIPUR,170281-Bharti Bal Niketan Sr.sec. School,113,567,567,0,567,0,100,100
193,109-JAIPUR,170428-Sainik Children Academy Sr. Sec. School,114,562,559,3,447,112,99.47,79.54
194,118-GANDHINAGAR,390107-Pragati International School,97,562,561,1,557,4,99.82,99.11
195,107-DELHI,050262-DELHI PUBLIC SCHOOL,160,558,519,39,459,60,93.01,82.26
196,106-KOCHI,090097-Naipunnya Public School,129,556,556,0,556,0,100,100
197,104-GUWAHATI,020075-Rangkut Krorsing High School,129,553,553,0,284,269,100,51.36
198,109-JAIPUR,170216-Maa Sharda Sr.sec. Public School,109,552,552,0,549,3,100,99.46
199,105-CHANDIGARH,M16056-Guru Nanak Public Sr Sec School,123,551,551,0,551,0,100,100
200,106-KOCHI,090103-Kendriya Vidyalaya,114,548,548,0,544,4,100,99.27
201,105-CHANDIGARH,050569-DELHI VIDYAPEETH ,118,547,547,0,546,1,100,99.82
202,109-JAIPUR,170127-Rajasthan Public School,113,546,546,0,546,0,100,100
203,106-KOCHI,M09099-Holy Grace Academy,118,545,545,0,463,82,100,84.95
204,107-DELHI,270098-Jeewan Jyoti Sr. Sec. School,118,544,544,0,505,39,100,92.83
205,109-JAIPUR,170343-L.b.s. Adarsh Vidhyalaya,111,542,542,0,542,0,100,100
206,107-DELHI,050664-Rao Puran Singh Public School,117,539,532,7,532,0,98.7,98.7
207,109-JAIPUR,170364-Lal Bahadur Shastri Sr. Sec. School,107,539,539,0,539,0,100,100
208,104-GUWAHATI,200004-R.k. Institution,120,533,529,4,345,184,99.25,64.73
209,109-JAIPUR,170443-Adarsh Sr. Sec. School,115,532,532,0,532,0,100,100
210,123-GANGTOK,220106-Rabindranath Higher Sec. School,107,530,527,3,527,0,99.43,99.43
211,107-DELHI,270209-Rajkiya Sarvodaya Bal Vidyalaya No1,116,526,468,58,329,139,88.97,62.55
212,114-DEHRADUN,M21543-Jamia Qasmia Darul Uloom,92,521,521,0,521,0,100,100
213,105-CHANDIGARH,050476-Baba Mungipa Sr.sec. School,122,513,513,0,443,70,100,86.35
214,114-DEHRADUN,M38342-Jamia Islahul Banaat,86,510,510,0,510,0,100,100
215,107-DELHI,270317-B.R.TYAGI SR.SEC.SCHOOL,110,508,475,33,470,5,93.5,92.52
216,104-GUWAHATI,120031-Mount Everest Hr. Sec. School,105,506,506,0,373,133,100,73.72
217,107-DELHI,270074-Kendriya Vidyalaya,106,505,502,3,336,166,99.41,66.53
218,109-JAIPUR,170053-Nehru Modern Secondary School,114,502,502,0,502,0,100,100
219,103-KOLKATA,460505-Fulbari High School,104,500,0,500,0,0,0,0
220,123-GANGTOK,220058-Paranami Balika Vidya Mandir,104,499,0,499,0,0,0,0
221,120-RANCHI,260184-Saraswati Shishu Vidya Mandir,113,499,499,0,499,0,100,100
222,109-JAIPUR,170347-Adarsh Senior Secondary School,109,498,498,0,498,0,100,100
223,109-JAIPUR,170348-Kamal Vidya Mandir Secondary School,105,497,497,0,497,0,100,100
224,104-GUWAHATI,130012-Douglas Memorial Secondary School,113,497,497,0,231,266,100,46.48
225,104-GUWAHATI,300014-Govt. Leitlangpui Higher Secondary,109,496,495,1,495,0,99.8,99.8
226,114-DEHRADUN,210799-Gurukul Vidyapeeth,98,495,492,3,489,3,99.39,98.79
227,109-JAIPUR,170269-Choudhary Educational Institute,95,494,494,0,403,91,100,81.58
228,125-JAMMU,070041-Jawahar Navodaya Vidyalaya,115,494,494,0,494,0,100,100
229,121-CHENNAI,190033-Kendriya Vidyalaya,120,494,490,4,195,295,99.19,39.47
230,107-DELHI,270149-Nav Jeevan Adarsh Pub.sr.sec.school,109,493,0,493,0,0,0,0
231,103-KOLKATA,460524-Herobhanga Vidyasagar,99,490,0,490,0,0,0,0
232,114-DEHRADUN,210670-Vidya Bhawan Public School,99,488,488,0,488,0,100,100
233,107-DELHI,270367-Govt Boys Sr.sec School,118,488,0,488,0,0,0,0
234,106-KOCHI,M09084-Al Irshad Sr.sec. English School,112,487,487,0,487,0,100,100
235,109-JAIPUR,170437-Choudhary Gharsiram Public School,96,485,485,0,485,0,100,100
236,109-JAIPUR,170290-Gyandeep Adarsh Senior Secondary Sc,93,485,485,0,475,10,100,97.94
237,104-GUWAHATI,M44001-Jaleswar Girls Higher secondary School,120,482,482,0,482,0,100,100
238,103-KOLKATA,220054-North Point Sr.sec.boarding School,102,481,389,92,167,222,80.87,34.72
239,118-GANDHINAGAR,390098-Shree Taxshila Vidyalaya,86,478,478,0,367,111,100,76.78
240,123-GANGTOK,180002-Namchi Govt.sr.sec. School,111,475,385,90,273,112,81.05,57.47
241,107-DELHI,270265-Govt Boys Sr Sec School,101,474,472,2,452,20,99.58,95.36
242,114-DEHRADUN,340162-Queen's Public School,116,472,471,1,464,7,99.79,98.31
243,115-BHUBANESWAR,410128-410128-Town High School,77,471,471,0,431,40,100,91.51
244,106-KOCHI,090038-Vedavyasa Vidyalayam Sr.secondary,105,471,471,0,298,173,100,63.27
245,107-DELHI,270521-New Delhi Public School,96,471,463,8,463,0,98.3,98.3
246,109-JAIPUR,170328-Shri Adarsh Vidya Mandir Senior,97,469,469,0,469,0,100,100
247,109-JAIPUR,170349-Shri Balaji Public SR.Sec. School,100,466,466,0,433,33,100,92.92
248,104-GUWAHATI,200022-Chailengta H.s.school,94,458,458,0,408,50,100,89.08
249,109-JAIPUR,170393-Pooja International Academy,106,457,454,3,328,126,99.34,71.77
250,120-RANCHI,260015-Dbms Carrer Academy,88,457,457,0,383,74,100,83.81
251,104-GUWAHATI,"020022-Don Bosco High School,",108,457,457,0,437,20,100,95.62
252,104-GUWAHATI,440012-Nabadaya Jatiya Bidyalaya,101,454,454,0,350,104,100,77.09
253,107-DELHI,270220-Kendriya Vidyalaya,100,454,0,454,0,0,0,0
254,121-CHENNAI,M38341-Kh Matriculation Boys Hr.sec.school,109,453,453,0,453,0,100,100
255,113-BHOPAL,100206-Amrit  Vidyapeeth School,95,451,451,0,444,7,100,98.45
256,103-KOLKATA,220004-Bholananda National Vidyalaya,95,451,437,14,388,49,96.9,86.03
257,109-JAIPUR,170312-New Bright Land Public Sr.sec.sch.,87,450,450,0,450,0,100,100
258,107-DELHI,270180-Vasant Valley School,107,450,285,165,182,103,63.33,40.44
259,105-CHANDIGARH,050429-Modern Senior Secondary School,92,450,450,0,450,0,100,100
260,107-DELHI,270415-Doon Public School,94,447,442,5,428,14,98.88,95.75
261,103-KOLKATA,220011-St.vincent's High& Technical School,107,442,421,21,336,85,95.25,76.02
262,114-DEHRADUN,340230-Govt. Inter College,99,442,442,0,440,2,100,99.55
263,105-CHANDIGARH,160038-Shastri Model School,98,441,441,0,432,9,100,97.96
264,107-DELHI,050373-Jyoti Public Sr.secondary School,97,440,440,0,372,68,100,84.55
265,106-KOCHI,090020-T.k.m. Higher Sec. School,95,439,439,0,341,98,100,77.68
266,109-JAIPUR,170337-Hillgrove Col's Academy,89,438,438,0,409,29,100,93.38
267,118-GANDHINAGAR,390101-Shree Matruvandan Secondary & Higher Secondary School,88,435,435,0,412,23,100,94.71
268,107-DELHI,270170-Govt. Boys Sr.sec.school,95,435,435,0,435,0,100,100
269,106-KOCHI,"090033-Mahatma Gandhi Public School,",93,432,432,0,426,6,100,98.61
270,107-DELHI,M21655-Fr. Agnel School,87,429,428,1,412,16,99.77,96.04
271,109-JAIPUR,170251-National Shikshan Sansthan,90,427,427,0,354,73,100,82.9
272,109-JAIPUR,170326-Pooja Sr.sec. School,89,425,425,0,425,0,100,100
273,107-DELHI,270484-Nalanda Modern Public School,89,424,423,1,31,392,99.76,7.31
274,105-CHANDIGARH,M05445-Mewat Adarsh Sr.sec. School,92,424,424,0,424,0,100,100
275,106-KOCHI,090019-Labour India Public School,94,424,424,0,420,4,100,99.06
276,107-DELHI,270395-Ch. Baldev Singh Model Sec.school,92,423,422,0,422,0,99.76,99.76
277,106-KOCHI,M09041-Darul Hikam Residential School,85,422,422,0,160,262,100,37.91
278,107-DELHI,270249-Psm Senior Secondary School,92,422,191,231,145,46,45.26,34.36
279,107-DELHI,270125-Kendriya Vidyalaya,91,420,414,6,36,378,98.57,8.57
280,114-DEHRADUN,210618-B.s.m. School,91,420,420,0,420,0,100,100
281,107-DELHI,270507-NAV JEEVAN ADARSH PUBLIC SCHOOL,93,419,38,381,30,8,9.07,7.16
282,106-KOCHI,M09107-Irshadiyya Public School,84,416,416,0,262,154,100,62.98
283,105-CHANDIGARH,050160-Geeta Sr.sec.school,91,410,409,1,397,12,99.76,96.83
284,107-DELHI,210210-Noida Public Senior Sec.school,87,410,408,2,0,408,99.51,0
285,109-JAIPUR,170433-Global Public Sr. Sec. School,81,410,410,0,410,0,100,100
286,106-KOCHI,090017-Sreeniketan Centre For Social,81,408,408,0,138,270,100,33.82
287,117-BENGALURU,080065-Clarence High School,86,406,406,0,377,29,100,92.86
288,104-GUWAHATI,020070-Nabadaya Jatiya Bidyalaya,92,400,400,0,336,64,100,84
289,123-GANGTOK,189001-Regional Centre-Gangtok,110,399,399,0,227,172,100,56.89
290,104-GUWAHATI,200024-New Hindi Secondary School,83,397,397,0,245,152,100,61.71
291,117-BENGALURU,080022-Delhi Public School,85,392,391,1,390,1,99.74,99.49
292,103-KOLKATA,M22098-St. Augustines Day School,117,392,121,271,84,37,30.87,21.43
293,111-ALLAHABAD/PRAYAGRAJ,M21351-A.a.khan Memorial Inter College,87,391,391,0,391,0,100,100
294,107-DELHI,050258-Bansi Vidya Niketan Sr. Sec. School,82,389,389,0,389,0,100,100
295,107-DELHI,210748-Ghaziabad Public School,86,387,0,387,0,0,0,0
296,104-GUWAHATI,240016-Govt. Higher Secondary School,86,383,380,3,303,77,99.22,79.11
297,107-DELHI,270382-Remal Public School,84,382,381,1,369,12,99.74,96.6
298,123-GANGTOK,M22096-Scottish Universities Mission,81,381,30,351,0,30,7.87,0
299,114-DEHRADUN,210736-Vishva Bharti Vidyapeeth,73,381,381,0,274,107,100,71.92
300,107-DELHI,270007-Col.satsangi's Kiran Memo. Aipeccs,89,380,379,1,379,0,99.74,99.74
301,103-KOLKATA,"220071-Kendriya Vidyalaya No.1, Afs,",83,379,379,0,379,0,100,100
302,121-CHENNAI,190005-The C.p.ramaswami Aiyar Foundation,89,379,338,41,338,0,89.18,89.18
303,103-KOLKATA,460502-Barasija Fulur Anchal Vidyalaya,72,379,0,379,0,0,0,0
304,107-DELHI,270508-BHARAT MATA SARASWATI BAL MANDIR SCHOOL,82,377,376,1,374,2,99.73,99.2
305,111-ALLAHABAD/PRAYAGRAJ,210430-Jawahar Navodaya Vidyalaya,76,376,375,1,374,1,99.73,99.47
306,113-BHOPAL,100050-Arjun Higher,82,375,372,3,0,372,99.2,0
307,107-DELHI,270309-Rahul Model Public School,80,374,368,6,360,8,98.4,96.26
308,118-GANDHINAGAR,040071-V.D.T Girls High School,78,373,373,0,281,92,100,75.34
309,104-GUWAHATI,130018-Tome Memorial Secondary School,88,373,372,1,348,24,99.73,93.3
310,114-DEHRADUN,M21332-Capital Public School,82,373,373,0,373,0,100,100
311,107-DELHI,270398-D V Public School,78,372,372,0,372,0,100,100
312,103-KOLKATA,220038-Don Bosco School,80,370,302,68,0,302,81.62,0
313,107-DELHI,050261-Drona Public School,80,369,37,332,0,37,10.03,0
314,107-DELHI,050129-Modern Sr. Secondary School,76,368,368,0,368,0,100,100
315,107-DELHI,270493-Sardar Patel Public Sr. Sec. School,77,367,367,0,356,11,100,97
316,103-KOLKATA,220035-St. Ambrose Vidyalaya,73,366,364,2,364,0,99.45,99.45
317,106-KOCHI,090067-Jawahar Navodaya Vidyalaya,81,366,365,1,95,270,99.73,25.96
318,109-JAIPUR,170396-Vidya Bharti Sr. Secondary School,76,366,359,7,192,167,98.09,52.46
319,104-GUWAHATI,130027-Jyoti Sroat School,88,366,363,3,295,68,99.18,80.6
320,104-GUWAHATI,020058-Prabhat Tara Children Eng.academy,86,365,364,1,363,1,99.73,99.45
321,107-DELHI,270323-Govt.boys Sr.Sec.School,84,365,359,6,359,0,98.36,98.36
322,103-KOLKATA,220076-Vikram Vidyalaya,71,364,0,364,0,0,0,0
323,115-BHUBANESWAR,410150-KALINGA INSTITUTE OF SOCIAL SCIENCES (KISS),75,363,361,2,292,69,99.45,80.44
324,106-KOCHI,M09110-Markaz Higher Secondary School for Boys,78,362,362,0,359,3,100,99.17
325,114-DEHRADUN,210698-Adarsh Shiksha Mandir Inter College,77,360,360,0,360,0,100,100
326,103-KOLKATA,220107-Malda Railway High School,77,358,357,1,331,26,99.72,92.46
327,114-DEHRADUN,M38199-Madarsa Islamia Talimul Quran,80,358,356,2,356,0,99.44,99.44
328,107-DELHI,270486-L.K. International School,76,358,356,2,178,178,99.44,49.72
329,109-JAIPUR,170329-Pole Star The School,74,357,357,0,357,0,100,100
330,107-DELHI,270336-Amrita Public School,78,357,0,357,0,0,0,0
331,118-GANDHINAGAR,390122-Brahmani Vidhyalay,71,357,357,0,356,1,100,99.72
332,106-KOCHI,090057-Kendriya Vidyalaya,76,355,355,0,351,4,100,98.87
333,105-CHANDIGARH,050075-K.c.m Army Sr.sec.school,83,354,352,2,351,1,99.44,99.15
334,114-DEHRADUN,M21505-Jamia Tut Tayyibat Niswan College,64,353,353,0,351,2,100,99.43
335,105-CHANDIGARH,160061-MOTHER CHHANKAUR CONVENT SCHOOL,74,350,350,0,311,39,100,88.86
336,107-DELHI,210215-Green Field Sr.sec.public School,76,350,0,350,0,0,0,0
337,105-CHANDIGARH,250010-Shivalik Public School,81,349,348,1,348,0,99.71,99.71
338,102-PUNE,M11112-Anglo Urdu Boys High School & Jr.,96,349,348,1,348,0,99.71,99.71
339,114-DEHRADUN,340222-R.c.d. Public School,75,344,344,0,227,117,100,65.99
340,104-GUWAHATI,140019-Govt. Hr. Sec. School,70,342,342,0,202,140,100,59.06
341,107-DELHI,M27483-Victoria Girls Senior Secondary School,77,342,339,3,339,0,99.12,99.12
342,125-JAMMU,070007-Kendriya Vidyalaya Leh,81,342,289,53,288,1,84.5,84.21
343,106-KOCHI,090077-Vimala Hridaya Icse School,72,338,338,0,331,7,100,97.93
344,104-GUWAHATI,020013-Doomdooma Junior College,90,336,331,5,317,14,98.51,94.35
345,118-GANDHINAGAR,040043-SUNGRACE VIDHYALAYA,67,335,335,0,264,71,100,78.81
346,103-KOLKATA,220008-Salkia Shri Vikram Balika Vidyalaya,65,335,335,0,334,1,100,99.7
347,105-CHANDIGARH,450173-Govt. Rehabilitation Inst. For Intellectual Disabilities,75,334,334,0,334,0,100,100
348,107-DELHI,210781-Adarsh Gyan Sarovar Public School,75,334,334,0,334,0,100,100
349,111-ALLAHABAD/PRAYAGRAJ,"210302-Mahavir Vidya Mandir Inter College,",74,334,334,0,300,34,100,89.82
350,114-DEHRADUN,340133-T.c.g. Public School,73,333,333,0,312,21,100,93.69
351,105-CHANDIGARH,050631-Sand Grove Sr. Sec. School,76,331,331,0,331,0,100,100
352,103-KOLKATA,220108-Kendriya Vidyalaya,67,330,0,330,0,0,0,0
353,103-KOLKATA,460533-Mount Litera Zee School,60,329,0,329,0,0,0,0
354,106-KOCHI,090051-Vyas Vidyaniketan Central School,66,329,329,0,327,2,100,99.39
355,114-DEHRADUN,340045-St. Joseph's Academy,84,329,328,1,328,0,99.7,99.7
356,107-DELHI,270462-Adarsh Lakhpat Model Sec. School,71,329,329,0,317,12,100,96.35
357,107-DELHI,270544-R C S Convent School,74,329,329,0,329,0,100,100
358,114-DEHRADUN,210152-Asha Modern School,72,327,294,33,294,0,89.91,89.91
359,107-DELHI,270431-Holy International Sr. Sec. School,68,325,320,0,320,0,98.46,98.46
360,107-DELHI,M21663-AYAN NATIONAL PUBLIC SCHOOL,65,324,298,26,3,295,91.98,0.93
361,102-PUNE,110080-Bharat Education Society,71,324,324,0,324,0,100,100
362,107-DELHI,270509-BHARTI VIDYA NIKETAN PUBLIC SCHOOL,73,323,288,35,99,189,89.16,30.65
363,106-KOCHI,090098-B.R. Memorial Central School,69,322,322,0,110,212,100,34.16
364,109-JAIPUR,170143-Ideal Public School,68,321,321,0,321,0,100,100
365,104-GUWAHATI,120061-BISHNULAL GOVERNMENT HIGH SCHOOL,73,319,319,0,293,26,100,91.85
366,109-JAIPUR,170033-Lamoria Girls Sec. School,70,317,317,0,317,0,100,100
367,103-KOLKATA,220115-Mal Ideal Hindi High School (h.s.),69,317,0,317,0,0,0,0
368,107-DELHI,270346-S.d.m. Model Secondary School,72,317,317,0,317,0,100,100
369,107-DELHI,270426-Pioneer Convent School,71,316,311,5,310,1,98.42,98.1
370,104-GUWAHATI,M02068-AMBARI BAZAR HIGH SCHOOL,75,314,314,0,314,0,100,100
371,109-JAIPUR,170436-Pink Pearl Shikshan Sansthan Sr. Sec. School,64,314,314,0,314,0,100,100
372,105-CHANDIGARH,050576-KOTA PUBLIC SCHOOL,74,313,313,0,235,78,100,75.08
373,117-BENGALURU,M08048-Delhi Public School,73,312,310,2,268,42,99.36,85.9
374,107-DELHI,270344-West Point Model School,64,312,312,0,312,0,100,100
375,104-GUWAHATI,240015-Govt. Higher Secondary School,70,310,310,0,309,1,100,99.68
376,106-KOCHI,090046-Kendriya Vidyalaya No-2,68,309,309,0,152,157,100,49.19
377,105-CHANDIGARH,050647-Vikas Sen Sec. School,72,307,307,0,114,193,100,37.13
378,121-CHENNAI,190006-Measi Matriculation Hr.sec. School,59,306,301,5,136,165,98.37,44.44
379,105-CHANDIGARH,050534-Yaduvanshi Shiksha Niketan,62,306,306,0,306,0,100,100
380,107-DELHI,270502-S.E.S BABA NEBHARAJ SR. SEC. SCHOOL,66,303,287,16,149,138,94.72,49.17
381,104-GUWAHATI,120057-Jawahar Navodaya Vidyalaya,65,301,301,0,188,113,100,62.46
382,105-CHANDIGARH,050577-ASHA DEEP SR. SEC. SCHOOL,67,300,300,0,300,0,100,100
383,125-JAMMU,070045-Srinagar Group of Schools,71,300,174,126,0,174,58,0
384,104-GUWAHATI,200015-Sabroom Boys Higher Sec. School,59,300,300,0,124,176,100,41.33
385,105-CHANDIGARH,250014-Gyandeep Model Sr.sec. School,68,299,292,7,115,177,97.66,38.46
386,107-DELHI,M38078-Institute of Advanced Studies In Education,61,299,296,3,284,12,99,94.98
387,107-DELHI,270510-HINDON PUBLIC SCHOOL ,64,299,297,2,297,0,99.33,99.33
388,121-CHENNAI,190136-The Pupil Saveetha Eco. School,69,297,293,4,193,100,98.65,64.98
389,118-GANDHINAGAR,390106-M V S High school,57,297,297,0,274,23,100,92.26
390,104-GUWAHATI,130002-Sacred Heart Girls Higher Secondary,59,297,293,4,237,56,98.65,79.8
391,105-CHANDIGARH,050296-Maharani Laxmi Bai Neo Convent,65,295,291,4,284,7,98.64,96.27
392,118-GANDHINAGAR,390117-Taxshila Vidyalaya,53,295,295,0,288,7,100,97.63
393,106-KOCHI,M09042-Mar Dionysius Sr.sec.school,67,293,292,1,283,9,99.66,96.59
394,109-JAIPUR,170295-Oxbridge International Sr. Sec. School,68,293,293,0,293,0,100,100
395,105-CHANDIGARH,160087-Genius Public School,69,293,293,0,293,0,100,100
396,118-GANDHINAGAR,040088-Shree Sharda Secondary & High. Secondary School,59,292,292,0,197,95,100,67.47
397,106-KOCHI,090079-Parama Bhajtara Kendriya Vidyalayam,60,292,292,0,78,214,100,26.71
398,114-DEHRADUN,340292-Biswas Red Rose Inter College,65,292,292,0,292,0,100,100
399,102-PUNE,280004-St. Xavier's Academy,66,291,291,0,291,0,100,100
400,105-CHANDIGARH,J05285-District Jail,61,288,286,2,90,196,99.31,31.25
401,107-DELHI,M27482-Guru Harkrishan Public School,62,287,237,50,185,52,82.58,64.46
402,107-DELHI,270498-Mother Divine Public School,63,287,286,1,286,0,99.65,99.65
403,107-DELHI,270300-Shashi Public Secondary School,62,286,81,203,0,81,28.32,0
404,103-KOLKATA,220096-Vivekanand Mission High School,51,286,286,0,272,14,100,95.1
405,109-JAIPUR,170346-Sainik Vidhya Mandir Sr.sec. School,59,286,286,0,286,0,100,100
406,107-DELHI,050168-St.soldiers Sr.sec.Public School,61,285,285,0,280,5,100,98.25
407,105-CHANDIGARH,050369-Pooja Modern Sr. Secondary School,65,284,283,1,283,0,99.65,99.65
408,109-JAIPUR,170302-Vandana Bal Vidya Niketan Senior,55,284,284,0,284,0,100,100
409,118-GANDHINAGAR,390110-Govt. Khetivadi Sec. & High Sec. School,71,283,283,0,280,3,100,98.94
410,107-DELHI,270203-R.d. Public Sr.sec.school,58,283,156,127,35,121,55.12,12.37
411,114-DEHRADUN,340272-Govt. Inter College,70,282,282,0,282,0,100,100
412,105-CHANDIGARH,050077-Adarsh Sr.sec.school,62,281,281,0,281,0,100,100
413,114-DEHRADUN,340208-Government Inter College,60,281,0,281,0,0,0,0
414,103-KOLKATA,220070-Bhetaguri Lal Bahadur Shastri Vidyapith,57,281,277,4,277,0,98.58,98.58
415,103-KOLKATA,220111-KENDRIYA VIDYALAYA IIMC JOKA,66,280,279,1,161,118,99.64,57.5
416,105-CHANDIGARH,160153-Gurdasi Devi Institute of Management & Technology,62,279,279,0,279,0,100,100
417,105-CHANDIGARH,M05300-Mewat Modern Academy,58,278,277,1,276,1,99.64,99.28
418,107-DELHI,210239-Diwakar Model School,55,277,0,277,0,0,0,0
419,109-JAIPUR,170229-Jawahar Navodaya Vidyalaya,64,277,275,2,159,116,99.28,57.4
420,105-CHANDIGARH,050532-Ningania Vidya Mandir High School,59,275,275,0,275,0,100,100
421,103-KOLKATA,220059-Indira Gandhi Memorial Sr.s. School,59,274,55,219,0,55,20.07,0
422,107-DELHI,270463-Mata Kasturi Devi Sr.sec.school,54,273,257,16,243,14,94.14,89.01
423,115-BHUBANESWAR,150192-Centurion University of Technology and Management,44,273,273,0,247,26,100,90.48
424,107-DELHI,270545-Royal International School,59,273,271,2,235,36,99.27,86.08
425,107-DELHI,270384-St.marks Sr.secondary Public School,56,271,267,4,265,2,98.52,97.79
426,107-DELHI,M27478-New Horizon School,58,271,271,0,235,36,100,86.72
427,118-GANDHINAGAR,M04036-Hanifa School (english Medium),53,270,270,0,204,66,100,75.56
428,111-ALLAHABAD/PRAYAGRAJ,210318-S.s.j.d Inter College,55,269,269,0,269,0,100,100
429,106-KOCHI,"M40008-Jdt Islam Orphanage & High School,",57,269,269,0,268,1,100,99.63
430,106-KOCHI,090096-Toc H (R) Public School,66,267,267,0,104,163,100,38.95
431,118-GANDHINAGAR,M39053-St. Xavier's Vidya Vihar,51,267,267,0,253,14,100,94.76
432,109-JAIPUR,170271-Shiv Saraswati Sr.sec.vidya Mandir,52,264,264,0,264,0,100,100
433,109-JAIPUR,170409-Gandhi Bal Niketan Sr. Sec. School,63,263,263,0,263,0,100,100
434,109-JAIPUR,170373-Gyandeep Shikshan Sansthan Senior,52,261,261,0,261,0,100,100
435,104-GUWAHATI,130023-Jawahar Navodaya Vidyalaya,56,261,254,7,108,146,97.32,41.38
436,114-DEHRADUN,M21487-Kissan Public Inter College,57,260,258,2,258,0,99.23,99.23
437,107-DELHI,050132-N.R.Hindu Sr.Sec.School,60,259,259,0,251,8,100,96.91
438,109-JAIPUR,170059-Arunodaya Shikshak Sansthan,56,259,259,0,257,2,100,99.23
439,107-DELHI,270500-Navyug Happy Public School,62,258,258,0,178,80,100,68.99
440,105-CHANDIGARH,050549-Bal Bharati Internationl Public Sch,66,256,256,0,256,0,100,100
441,114-DEHRADUN,340220-Kingston Public School,48,255,255,0,255,0,100,100
442,107-DELHI,270287-Pt. Yadram Sec. Public School,53,255,255,0,124,131,100,48.63
443,103-KOLKATA,460507-Jagadishpur High School,51,254,250,4,249,1,98.43,98.03
444,114-DEHRADUN,340118-Govt. Inter College Champawat,54,253,253,0,253,0,100,100
445,118-GANDHINAGAR,390104-PRAGATI GIRLS HIGH SCHOOL,60,253,253,0,160,93,100,63.24
446,104-GUWAHATI,"M14017-St. Peter's School,",56,253,253,0,246,7,100,97.23
447,104-GUWAHATI,020007-Kendriya Vidyalaya,53,250,250,0,159,91,100,63.6
448,117-BENGALURU,M08049-Delhi Public School,68,249,248,1,195,53,99.6,78.31
449,120-RANCHI,260097-+2 Zila School,50,249,249,0,249,0,100,100
450,106-KOCHI,090102-Kendriya Vidyalaya,52,249,249,0,249,0,100,100
451,104-GUWAHATI,240026-ZENITH CHILD SCHOOL,58,248,246,2,197,49,99.19,79.44
452,104-GUWAHATI,020038-Kendriya Vidyalaya,57,247,245,2,165,80,99.19,66.8
453,114-DEHRADUN,210586-Lakshya Public School,50,246,246,0,240,6,100,97.56
454,115-BHUBANESWAR,410127-Centurion University Of Technology,43,244,244,0,229,15,100,93.85
455,101-HYDERABAD,"470011-T.s.w.rschool Jr.college(b),",51,243,243,0,243,0,100,100
456,109-JAIPUR,"170060-H.r. Memorial Public School,",50,243,243,0,242,1,100,99.59
457,109-JAIPUR,170265-M.d.bhati Saraswati Niketan,51,242,242,0,242,0,100,100
458,109-JAIPUR,170333-Neha Public Sr.sec. School,48,242,242,0,237,5,100,97.93
459,107-DELHI,270381-Saraswati Public Secondary School,54,241,241,0,241,0,100,100
460,114-DEHRADUN,340199-Govt. Inter College,51,241,241,0,241,0,100,100
461,114-DEHRADUN,340321-Subhash Smarak Inter College,49,241,241,0,241,0,100,100
462,114-DEHRADUN,M34253-Madarsa Maulana Abul Kalam Azad,45,240,240,0,240,0,100,100
463,103-KOLKATA,220129-Swami Vivekananda Vidyamandir,49,239,171,68,35,136,71.55,14.64
464,114-DEHRADUN,340277-Matrabhumi Inter College,53,238,238,0,238,0,100,100
465,107-DELHI,M27481-GURU NANAK PUBLIC SCHOOL,52,237,0,237,0,0,0,0
466,107-DELHI,210440-S S International School,52,237,5,232,5,0,2.11,2.11
467,107-DELHI,270332-Citizen Model School,48,236,234,2,232,2,99.15,98.31
468,107-DELHI,210439-S S K Sr.sec.school,58,236,231,5,97,134,97.88,41.1
469,109-JAIPUR,170123-Shishu Bharti Sr.sec.school,51,236,231,5,228,3,97.88,96.61
470,118-GANDHINAGAR,390115-Prizam School Of Science,48,235,235,0,233,2,100,99.15
471,115-BHUBANESWAR,450122-Srusti Society For Rural,41,234,233,1,231,2,99.57,98.72
472,109-JAIPUR,170250-Swami Vivekanand Sr.sec. School,41,234,234,0,234,0,100,100
473,114-DEHRADUN,210403-Khalsa Public Inter College,56,234,234,0,234,0,100,100
474,104-GUWAHATI,130001-Kendriya Vidyalaya,53,234,234,0,230,4,100,98.29
475,107-DELHI,270447-D.R.P. Convent Secondary School,49,233,233,0,233,0,100,100
476,107-DELHI,270513-Joseph & Mary  Senior Secondary School,49,233,0,233,0,0,0,0
477,107-DELHI,270147-Mount St. Mary's,51,232,231,1,230,1,99.57,99.14
478,107-DELHI,050255-Tarun Niketan Sr.secondary School,49,232,0,232,0,0,0,0
479,108-ABROAD/NIOS HQ,950018-Time Training Centre,46,232,232,0,232,0,100,100
480,113-BHOPAL,M10228-Deniyat Fadeha  Madarsa,46,232,119,113,0,119,51.29,0
481,121-CHENNAI,190102-Vels Vidyashram,58,231,208,23,201,7,90.04,87.01
482,107-DELHI,210510-Campus School,54,230,230,0,132,98,100,57.39
483,105-CHANDIGARH,"250003-Shivalik Public School, Mohali",50,228,228,0,227,1,100,99.56
484,107-DELHI,270290-Prince Public School Sr. Sec.school,50,228,0,228,0,0,0,0
485,113-BHOPAL,100184-Sarvodaya Higher Secondary School,54,228,228,0,165,63,100,72.37
486,105-CHANDIGARH,050058-Yog High School,48,227,227,0,227,0,100,100
487,115-BHUBANESWAR,150005-Redwoods English School,42,226,226,0,183,43,100,80.97
488,114-DEHRADUN,340003-Children's Academy,50,224,2,222,2,0,0.89,0.89
489,101-HYDERABAD,470196-Kendriya Vidyalaya,51,224,41,183,2,39,18.3,0.89
490,107-DELHI,270183-Vanasthali Public School,52,223,223,0,202,21,100,90.58
491,118-GANDHINAGAR,040037-Shree Swaminarayan Academy,47,223,223,0,149,74,100,66.82
492,102-PUNE,280005-Vivekanand Vidyalaya,40,223,223,0,223,0,100,100
493,103-KOLKATA,220010-St. Teresa's Secondary School,51,222,217,5,17,200,97.75,7.66
494,120-RANCHI,260171-S.s. +2 High School,55,222,0,222,0,0,0,0
495,109-JAIPUR,170390-Vikram Shikshan Sansthan Sr.Sec.Sch,48,222,222,0,56,166,100,25.23
496,107-DELHI,270291-Maharaja Aggarsain Public School,49,220,220,0,141,79,100,64.09
497,123-GANGTOK,220079-Godwin Modern School,42,218,218,0,197,21,100,90.37
498,105-CHANDIGARH,160022-Punjab Model Sr. Sec School,43,217,216,1,212,4,99.54,97.7
499,117-BENGALURU,M08016-St. John's High School,48,217,217,0,209,8,100,96.31
500,109-JAIPUR,170278-Jagriti Senior Secondary School,49,216,202,14,114,88,93.52,52.78
501,107-DELHI,050473-S.d. Senior Secondary School,50,216,216,0,216,0,100,100
502,123-GANGTOK,180004-Deorali Govt.sr.sec. School,51,215,215,0,171,44,100,79.53
503,118-GANDHINAGAR,040075-Shannen Kids School,48,215,214,1,134,80,99.53,62.33
504,115-BHUBANESWAR,150202-MAHAMAYA JR. COLLEGE,40,214,113,101,89,24,52.8,41.59
505,107-DELHI,270006-St. Francis De Sales Sr.sec. School,46,213,213,0,154,59,100,72.3
506,103-KOLKATA,220016-St. James High School,48,213,194,19,155,39,91.08,72.77
507,104-GUWAHATI,020076-Bishnu Rabha High School,48,211,211,0,145,66,100,68.72
508,107-DELHI,M27488-Kalgidhar Khalsa Sr. Sec. School,46,210,209,1,204,5,99.52,97.14
509,114-DEHRADUN,340192-Jimp Pioneer School,42,210,210,0,209,1,100,99.52
510,107-DELHI,270401-Cosmos School,46,210,0,210,0,0,0,0
511,105-CHANDIGARH,050026-New Era Senior Secondary School,53,210,210,0,210,0,100,100
512,109-JAIPUR,170354-OM VIDYA MANDIR SR. SEC. SCHOOL,47,209,209,0,128,81,100,61.24
513,114-DEHRADUN,340143-Mahesha Nand  Bahuguna Inter,45,209,209,0,209,0,100,100
514,113-BHOPAL,100055-Bharat Mata Hr.sec.school,42,208,205,3,205,0,98.56,98.56
515,105-CHANDIGARH,050169-Maharishi Vidya Mandir,48,206,205,1,205,0,99.51,99.51
516,105-CHANDIGARH,050660-R.K. International School,49,205,205,0,205,0,100,100
517,117-BENGALURU,M08021-Deffodils High School,38,205,205,0,177,28,100,86.34
518,111-ALLAHABAD/PRAYAGRAJ,M21353-Saint Kabir Inter College,52,205,205,0,205,0,100,100
519,107-DELHI,M27402-St.marys School,40,205,205,0,203,2,100,99.02
520,121-CHENNAI,450011-The Spastic Society Of Tamilnadu,47,204,190,14,190,0,93.14,93.14
521,107-DELHI,270501-NATHU RAM CONVENT SCHOOL,45,203,200,3,43,157,98.52,21.18
522,105-CHANDIGARH,160113-Himalaya Modern Sr.sec. School,46,203,201,2,199,2,99.01,98.03
523,107-DELHI,050162-SARASWATI SR.SEC.SCHOOL,42,202,110,92,0,110,54.46,0
524,103-KOLKATA,460516-Midnapore Town School,38,202,202,0,100,102,100,49.5
525,105-CHANDIGARH,160110-H.s.d. Girls Sr. Sec. School,43,202,202,0,202,0,100,100
526,102-PUNE,110115-Navneet Jr. College Of Arts,42,201,201,0,179,22,100,89.05
527,114-DEHRADUN,M21368-Madarsa Islahul Muslimeen,37,201,201,0,201,0,100,100
528,105-CHANDIGARH,M16108-Khalsa Public Sr.Sec. School,45,200,200,0,191,9,100,95.5
529,107-DELHI,050156-Adharsh Bal Vidya Kendrasr.s.school,44,199,193,6,183,10,96.98,91.96
530,103-KOLKATA,M22100-SAMARITAN MISSION SCHOOL(HIGH),43,199,199,0,186,13,100,93.47
531,103-KOLKATA,220052-Maria's Day School,42,199,199,0,199,0,100,100
532,107-DELHI,270412-B.S.M. Public School,45,198,198,0,157,41,100,79.29
533,104-GUWAHATI,020074-Adarsha Hindi Vidyalaya H.E. School,48,197,196,1,116,80,99.49,58.88
534,107-DELHI,270419-C.r. Oasis Convent School,40,197,0,197,0,0,0,0
535,107-DELHI,050408-S.d.m. High School,43,197,197,0,197,0,100,100
536,114-DEHRADUN,340061-Modern School,49,196,126,70,4,122,64.29,2.04
537,114-DEHRADUN,M38367-Muslim Inter College,49,196,194,2,192,2,98.98,97.96
538,107-DELHI,270341-Jain Bharti Model School,40,196,0,196,0,0,0,0
539,114-DEHRADUN,210212-Modern Public School,42,195,161,34,161,0,82.56,82.56
540,104-GUWAHATI,M02071-KANCHANPUR MEDHA VIKASH VIDYALAYA,44,195,195,0,191,4,100,97.95
541,109-JAIPUR,170405-GAYATRI VIDYA MANDIR SR. SEC. SCHOOL,38,194,194,0,194,0,100,100
542,109-JAIPUR,M17272-Khalsa Academy,50,193,192,1,115,77,99.48,59.59
543,107-DELHI,270453-New Sainik Public School,38,191,185,6,175,10,96.86,91.62
544,107-DELHI,270436-B.S.M. Senior Secondary School,41,191,190,1,167,23,99.48,87.43
545,107-DELHI,270467-SIDHHARTHA PUBLIC SCHOOL,41,190,106,84,62,44,55.79,32.63
546,106-KOCHI,090007-Anjali Hindi College,41,189,189,0,118,71,100,62.43
547,109-JAIPUR,170424-Choudhary Bal Sr. Sec. School,46,187,187,0,186,1,100,99.47
548,107-DELHI,270524-Srilal Convent Sr. Secondary School,40,186,186,0,186,0,100,100
549,113-BHOPAL,M10274-Madarsa Nascent Diniyat,29,184,184,0,184,0,100,100
550,107-DELHI,050601-Doon Bharti Public Sr. sec School,37,184,19,165,0,19,10.33,0
551,118-GANDHINAGAR,040089-Taxshila Vidyalaya,36,183,183,0,183,0,100,100
552,104-GUWAHATI,020036-Kendriya Vidyalaya,40,183,182,1,123,59,99.45,67.21
553,105-CHANDIGARH,050226-Gyan Deep Sr.Sec School,39,182,182,0,25,157,100,13.74
554,104-GUWAHATI,130024-Montfort Hr.secondary School,40,182,182,0,117,65,100,64.29
555,107-DELHI,270526-S.D Hari Mandir Girls Sr. Sec. School,40,182,182,0,182,0,100,100
556,107-DELHI,"270399-Decent Public School, Rohini",41,181,0,181,0,0,0,0
557,104-GUWAHATI,020015-Sree Narasinghasthan High School,36,180,180,0,102,78,100,56.67
558,103-KOLKATA,220025-St. Mary Gorretti Girls' High School,40,179,0,179,0,0,0,0
559,107-DELHI,050593-D R A Sr. Secondary School,44,179,179,0,175,4,100,97.77
560,107-DELHI,270360-Holy Convent Sr. Sec School,37,178,178,0,129,49,100,72.47
561,104-GUWAHATI,"200016-Amarpur Boys Hr.sec.school,",34,178,178,0,124,54,100,69.66
562,107-DELHI,210755-COLUMBIA CONVENT INSTITUTE,39,178,0,178,0,0,0,0
563,103-KOLKATA,M38111-Anglo Arabic Secondary School,43,177,169,8,156,13,95.48,88.14
564,105-CHANDIGARH,M05444-Mata Gujri Public School,39,177,173,4,101,72,97.74,57.06
565,103-KOLKATA,230005-Govt. Senior Secondary School,34,177,0,177,0,0,0,0
566,103-KOLKATA,460514-Lakhuria High School,33,176,0,176,0,0,0,0
567,109-JAIPUR,170322-Shivaji Bal Niketan Sr.sec. School,37,176,172,4,49,123,97.73,27.84
568,107-DELHI,050085-Holy Child Sr. Sec. School,35,176,176,0,176,0,100,100
569,105-CHANDIGARH,050445-M. S. Senior Secondary School,37,176,176,0,159,17,100,90.34
570,107-DELHI,"M27376-Carmel Convent School,",38,175,170,5,95,75,97.14,54.29
571,121-CHENNAI,190068-Govt. Boys Higher Secondary School,58,174,0,174,0,0,0,0
572,104-GUWAHATI,020063-Sai Rns Academy,39,174,170,4,121,49,97.7,69.54
573,106-KOCHI,M09076-Narikkuni English Medium School,35,174,174,0,66,108,100,37.93
574,104-GUWAHATI,120014-Ma Whab Islamic For S.c.pub.school,37,174,174,0,143,31,100,82.18
575,107-DELHI,210249-S.g.public School,38,173,0,173,0,0,0,0
576,104-GUWAHATI,M02069-Jaleswar Girls Higher secondary School,47,173,173,0,173,0,100,100
577,114-DEHRADUN,340126-Govt. Intermediate College,42,172,165,7,107,58,95.93,62.21
578,102-PUNE,M11066-Fr. Agnel Multipurpose School,46,172,171,1,155,16,99.42,90.12
579,109-JAIPUR,170305-Dr. Radhakrishnan Public Sec.school,38,172,170,2,170,0,98.84,98.84
580,105-CHANDIGARH,050108-Arya Senior Secondary School,36,172,172,0,172,0,100,100
581,107-DELHI,270207-Govt Sarvodaya Co Ed.vidyalaya,38,172,0,172,0,0,0,0
582,109-JAIPUR,170392-Adarsh Bal Nikunj Sr.Sec.School,36,172,158,14,75,83,91.86,43.6
583,104-GUWAHATI,140030-Mayangnokcha Govt. Hr.Sec. School,35,171,171,0,116,55,100,67.84
584,107-DELHI,"270388-Brahma Shakti Public School,",35,171,165,6,69,96,96.49,40.35
585,118-GANDHINAGAR,390105-V.D.T Girls High School,32,171,171,0,125,46,100,73.1
586,118-GANDHINAGAR,390077-Saraswat International Academy,37,171,171,0,171,0,100,100
587,105-CHANDIGARH,050649-B.P.R. Public School,34,170,170,0,153,17,100,90
588,115-BHUBANESWAR,J15160-Circle Jail,34,169,141,28,113,28,83.43,66.86
589,107-DELHI,"270141-Govt. Sarvodaya Bal Vidyalaya, Ramesh Nagar",37,169,134,35,134,0,79.29,79.29
590,105-CHANDIGARH,050211-Nirmal Sr. Sec. Public School,37,169,169,0,138,31,100,81.66
591,109-JAIPUR,170297-Kamla Shikshan Sansthan,33,168,168,0,168,0,100,100
592,118-GANDHINAGAR,040010-Logos Mission Hr.sec School,40,168,167,1,141,26,99.4,83.93
593,118-GANDHINAGAR,040078-Pragati International School,29,167,167,0,167,0,100,100
594,120-RANCHI,260205-KASIDIH HIGH SCHOOL,34,166,166,0,153,13,100,92.17
595,118-GANDHINAGAR,390086-Ranuj High School,32,166,166,0,163,3,100,98.19
596,118-GANDHINAGAR,M39052-Shama High School,36,166,166,0,165,1,100,99.4
597,104-GUWAHATI,M02023-Mont Fort School,39,165,162,3,121,41,98.18,73.33
598,106-KOCHI,M09065-Ideal English Hr.sec.school,34,165,165,0,60,105,100,36.36
599,111-ALLAHABAD/PRAYAGRAJ,210182-Bal Vidyapeeth,37,164,97,67,26,71,59.15,15.85
600,105-CHANDIGARH,M16061-Mother Chhan Kaur Convent School,37,164,164,0,164,0,100,100
601,118-GANDHINAGAR,390062-Bright High School,33,164,163,1,138,25,99.39,84.15
602,120-RANCHI,260173-+2 Zila School,36,164,164,0,164,0,100,100
603,102-PUNE,280009-Vivdha Vidya Pratisthan's,32,163,163,0,163,0,100,100
604,102-PUNE,110139-Kendriya Vidyalaya,39,163,162,1,162,0,99.39,99.39
605,114-DEHRADUN,340211-Himalaya Vidya Mandir Sr.sec.school,40,162,161,1,160,1,99.38,98.77
606,107-DELHI,270540-Bhagat International School,35,162,162,0,162,0,100,100
607,114-DEHRADUN,340316-Sangam Children Academy,36,161,161,0,161,0,100,100
608,117-BENGALURU,080005-St. Ann's High School,33,161,161,0,156,5,100,96.89
609,115-BHUBANESWAR,150006-Daniel Public School,28,161,160,1,135,25,99.38,83.85
610,109-JAIPUR,170272-Vikas Public School,35,161,161,0,161,0,100,100
611,114-DEHRADUN,210694-St. Mary's School,39,160,159,1,158,1,99.38,98.75
612,113-BHOPAL,"100073-Janta Higher Secondary School,",33,160,160,0,147,13,100,91.88
613,125-JAMMU,070022-Bright Furture Higher Secondary,40,159,159,0,117,42,100,73.58
614,107-DELHI,270408-RICHMONDD GLOBAL SCHOOL,35,159,0,159,0,0,0,0
615,107-DELHI,270154-Govt. Sarvodaya Bal Vidyalaya,35,159,0,159,0,0,0,0
616,107-DELHI,270531-Daffodil Public School,39,159,158,1,156,2,99.37,98.11
617,109-JAIPUR,170371-Global International Academy,31,158,158,0,154,4,100,97.47
618,114-DEHRADUN,M38268-Jamia Qasmia Darul Uloom,28,158,158,0,158,0,100,100
619,105-CHANDIGARH,050612-Vishwas Nav Sharda Public School,37,158,158,0,158,0,100,100
620,109-JAIPUR,170381-SHIV BAL VIDYA MANDIR SR. SEC. SCHOOL,31,158,158,0,158,0,100,100
621,115-BHUBANESWAR,410130-410130-Brajamohan High School,33,157,139,18,105,34,88.54,66.88
622,105-CHANDIGARH,M16042-St. Soldier Inter. Convent School,32,157,157,0,137,20,100,87.26
623,118-GANDHINAGAR,390082-SUNGRACE VIDHYALAYA,33,157,157,0,144,13,100,91.72
624,105-CHANDIGARH,050450-Arya Senior Secondary School,35,157,157,0,124,33,100,78.98
625,106-KOCHI,M40006-Ai-ameen College,32,157,157,0,76,81,100,48.41
626,105-CHANDIGARH,160078-Jawahar Navodaya Vidyalaya,34,155,155,0,103,52,100,66.45
627,104-GUWAHATI,200010-Kendriya Vidyalaya,41,155,155,0,148,7,100,95.48
628,107-DELHI,270494-U.S.M. Public Sr.Sec. School,29,155,155,0,155,0,100,100
629,123-GANGTOK,220030-Nepali Girls Social Service Centre,28,155,154,1,153,1,99.35,98.71
630,106-KOCHI,M09097-Hsm Higher Secondary School,31,155,155,0,73,82,100,47.1
631,109-JAIPUR,170219-Miranda Secondary School,29,155,155,0,155,0,100,100
632,114-DEHRADUN,340270-Govt. Inter College,32,154,154,0,154,0,100,100
633,104-GUWAHATI,M13019-Nabhajyoti Paham G/A Hr. Sec. School,31,154,154,0,120,34,100,77.92
634,115-BHUBANESWAR,150199-KALINGA INSTITUTE OF SOCIAL SCIENCES (KISS),33,154,119,35,81,38,77.27,52.6
635,114-DEHRADUN,340191-Dayanand Inter College,32,153,153,0,122,31,100,79.74
636,113-BHOPAL,100053-Saraswati Hr. Sec. School Gondkala,34,153,153,0,153,0,100,100
637,103-KOLKATA,230011-Govt. Senior Secondary School,29,153,102,51,0,102,66.67,0
638,103-KOLKATA,220125-Boon English School,30,152,0,152,0,0,0,0
639,109-JAIPUR,170419-Baldev Public Sr. Sec. School,30,152,152,0,152,0,100,100
640,105-CHANDIGARH,050404-Spring Daisy Convent School,32,152,151,1,151,0,99.34,99.34
641,121-CHENNAI,M19103-Al Hira Model School,34,151,151,0,151,0,100,100
642,107-DELHI,270556-Evergreen Public School,32,149,149,0,149,0,100,100
643,104-GUWAHATI,140015-Eastern School,34,149,149,0,149,0,100,100
644,114-DEHRADUN,210237-Amorha Muslim Girls Inter College,35,149,0,149,0,0,0,0
645,114-DEHRADUN,210174-AMAR SHAHEED MEMORIAL INTER COLLEGE,34,148,148,0,147,1,100,99.32
646,107-DELHI,270457-Rani Public School,34,148,148,0,126,22,100,85.14
647,114-DEHRADUN,210207-Naveen Kumar Bharti Shishu Upwan Inter College,36,147,147,0,147,0,100,100
648,103-KOLKATA,220103-Budge Budge St. Pauls Day School,29,146,0,146,0,0,0,0
649,103-KOLKATA,220044-Kendriya Vidyalaya,33,146,0,146,0,0,0,0
650,105-CHANDIGARH,050407-A. Xavier's International School,29,145,143,2,27,116,98.62,18.62
651,120-RANCHI,260001-Indian School Of Learning,34,145,145,0,145,0,100,100
652,107-DELHI,270519-Upadhyay Convent School,31,144,144,0,59,85,100,40.97
653,102-PUNE,280001-Pope John Xxiii High School,26,144,144,0,144,0,100,100
654,115-BHUBANESWAR,150031-Kendriya Vidyalaya,29,144,143,1,115,28,99.31,79.86
655,106-KOCHI,M09104-HAIL MARY ENGLISH MEDIUM Resi. HS School,32,144,144,0,142,2,100,98.61
656,114-DEHRADUN,210558-Jain Academy,27,144,144,0,144,0,100,100
657,105-CHANDIGARH,160135-G.G.S. Public Sr.Sec. School,32,144,144,0,128,16,100,88.89
658,105-CHANDIGARH,M16116-GOLDEN PUBLIC SCHOOL,30,143,143,0,143,0,100,100
659,105-CHANDIGARH,050367-Shiksha Bharti Vidya Niketan,32,143,143,0,117,26,100,81.82
660,113-BHOPAL,"M10066-Annie Besant Higher Sec School,",32,142,116,26,0,116,81.69,0
661,109-JAIPUR,170081-Children Sr. School,37,142,133,9,105,28,93.66,73.94
662,102-PUNE,280003-Copuchin Friars Minor Society,26,142,141,1,120,21,99.3,84.51
663,125-JAMMU,070029-Jawahar Navodaya Vidyalaya,33,141,141,0,97,44,100,68.79
664,107-DELHI,270506-C.M. MODEL SCHOOL,30,140,134,6,134,0,95.71,95.71
665,109-JAIPUR,M17091-Jametur Hidaya,30,140,140,0,130,10,100,92.86
666,120-RANCHI,260030-Ramakrishna Mission Ashrama,29,140,140,0,140,0,100,100
667,111-ALLAHABAD/PRAYAGRAJ,M21606-Sri Vardhaman Inter College,27,140,140,0,140,0,100,100
668,107-DELHI,050019-Kendriya Vidyalaya No. 1,33,140,0,140,0,0,0,0
669,123-GANGTOK,180015-Govt. Senior Secondary School,32,139,139,0,135,4,100,97.12
670,106-KOCHI,090056-Kendriya Vidyalaya,35,139,139,0,134,5,100,96.4
671,111-ALLAHABAD/PRAYAGRAJ,210303-Janta Inter College,28,138,138,0,138,0,100,100
672,114-DEHRADUN,340311-Ambition Public Sr.Sec. School,32,138,138,0,138,0,100,100
673,120-RANCHI,260075-Vidya Vihar Girls High School,31,137,136,1,136,0,99.27,99.27
674,107-DELHI,270302-Indra Prastha Convent Sr.sec.school,28,137,137,0,137,0,100,100
675,118-GANDHINAGAR,040099-S S School of Science,28,137,137,0,122,15,100,89.05
676,107-DELHI,270461-M.N.B. Modern Secondary School,33,137,136,1,134,2,99.27,97.81
677,118-GANDHINAGAR,040054-Maruti High School,24,137,137,0,111,26,100,81.02
678,105-CHANDIGARH,M16044-Kirpal Sagar Academy,28,137,137,0,137,0,100,100
679,107-DELHI,270468-Sky Hawk International School,29,137,64,73,18,46,46.72,13.14
680,118-GANDHINAGAR,390053-Gracious English,28,136,136,0,136,0,100,100
681,107-DELHI,270537-Tyagi Public School,27,136,136,0,129,7,100,94.85
682,105-CHANDIGARH,050046-Saini Sr.sec.school,27,136,136,0,136,0,100,100
683,109-JAIPUR,170243-Govt. Sardar Hr. Secondary School,29,136,134,2,126,8,98.53,92.65
684,104-GUWAHATI,M13016-St.xavier's Secondary School,29,135,135,0,129,6,100,95.56
685,120-RANCHI,260046-D A V Kapildev Public School,32,135,0,135,0,0,0,0
686,103-KOLKATA,220078-Vidya Niketan,29,135,66,69,0,66,48.89,0
687,109-JAIPUR,170242-Shahid Amit Bhardwaj Govt. Senior,30,134,134,0,129,5,100,96.27
688,114-DEHRADUN,340249-Janki Children Academy,29,134,131,3,118,13,97.76,88.06
689,107-DELHI,270383-Mater Dei School,30,134,0,134,0,0,0,0
690,101-HYDERABAD,470002-St. Vincent High School,27,134,134,0,134,0,100,100
691,114-DEHRADUN,340127-Govt. Inter College,30,133,110,23,110,0,82.71,82.71
692,107-DELHI,210667-Nilgiri Hills Public School,29,133,0,133,0,0,0,0
693,118-GANDHINAGAR,"M04025-Don Bosco High School,",32,133,131,2,92,39,98.5,69.17
694,102-PUNE,M11131-DON BOSCO SENIOR SECONDARY SCHOOL,30,132,125,7,118,7,94.7,89.39
695,106-KOCHI,090101-Kendriya Vidyalaya,27,132,132,0,80,52,100,60.61
696,114-DEHRADUN,340084-Maharishi Vidya Mandir,35,132,0,132,0,0,0,0
697,123-GANGTOK,180016-Govt. Senior Secondary School,29,130,95,35,91,4,73.08,70
698,115-BHUBANESWAR,410129-410129-Police High School,27,130,120,10,89,31,92.31,68.46
699,109-JAIPUR,170280-Lovely Diamond Senior Sec.school,32,130,130,0,53,77,100,40.77
700,102-PUNE,"110017-M. G. M. Academy's Junior College of Arts, Commerce & Science",29,130,128,2,128,0,98.46,98.46
701,102-PUNE,M11037-Don Bosco High School Jr.College,37,130,129,1,127,2,99.23,97.69
702,109-JAIPUR,170391-Bal Gopal Sr.Sec. School,26,130,130,0,130,0,100,100
703,110-PATNA,"030258-R.m.k. Inter School,",30,129,125,4,122,3,96.9,94.57
704,102-PUNE,280002-Auxilium High School,28,129,128,1,128,0,99.22,99.22
705,104-GUWAHATI,M02061-Abdul Hasib Higher Secondary School,26,128,128,0,124,4,100,96.88
706,104-GUWAHATI,120028-The Tentha High School,27,128,128,0,126,2,100,98.44
707,111-ALLAHABAD/PRAYAGRAJ,210034-Kendriya Vidyalaya,33,128,128,0,128,0,100,100
708,105-CHANDIGARH,050370-Kalyan Sr.sec. School,28,127,127,0,125,2,100,98.43
709,110-PATNA,030103-Brijishore Dharnighar Rajkiya Balak,27,127,111,16,103,8,87.4,81.1
710,105-CHANDIGARH,050640-Shivalik Sr. Sec. School,27,127,127,0,46,81,100,36.22
711,107-DELHI,270491-Rahul Public School,27,127,110,17,97,13,86.61,76.38
712,109-JAIPUR,170285-Newai Vidyapeeth Sr.sec. School,27,126,110,16,110,0,87.3,87.3
713,104-GUWAHATI,240028-Govt. Secondary School,25,126,124,2,95,29,98.41,75.4
714,115-BHUBANESWAR,410135-410135-AJO HIGH SCHOOL,27,126,126,0,125,1,100,99.21
715,105-CHANDIGARH,050635-The Scholars Public School,32,126,126,0,126,0,100,100
716,114-DEHRADUN,M38160-H.b.h.inter College,32,126,126,0,126,0,100,100
717,105-CHANDIGARH,050583-KAPIL VIDYA MANDIR SR. SEC. SCHOOL,28,126,126,0,50,76,100,39.68
718,110-PATNA,"030325-Mandwari +2 High School,",27,125,125,0,125,0,100,100
719,107-DELHI,210797-Bansraj Model School,29,125,125,0,125,0,100,100
720,117-BENGALURU,M38354-SHAHEEN URDU HIGH SCHOOL,25,125,125,0,125,0,100,100
721,105-CHANDIGARH,J05007-Distt. Jail,23,125,125,0,54,71,100,43.2
722,107-DELHI,050542-Vidya School,25,124,0,124,0,0,0,0
723,121-CHENNAI,M19101-Crescent Matric Hr.sec. School,25,124,124,0,124,0,100,100
724,114-DEHRADUN,210228-Gyandeep Sr.secondary School,26,124,124,0,124,0,100,100
725,110-PATNA,030058-Kendriya Vidyalaya,27,124,124,0,7,117,100,5.65
726,105-CHANDIGARH,050403-Mrcr Public School,31,124,124,0,114,10,100,91.94
727,103-KOLKATA,230004-Government Sr. Secondary School,23,123,99,24,50,49,80.49,40.65
728,118-GANDHINAGAR,390060-Tree House High School,28,123,123,0,121,2,100,98.37
729,118-GANDHINAGAR,390121-Swami Vivekanand Vidhyalaya,27,123,123,0,114,9,100,92.68
730,111-ALLAHABAD/PRAYAGRAJ,210791-K S Pandey Public Academy,28,122,121,1,120,1,99.18,98.36
731,106-KOCHI,M40054-Markazul Uloom English School,25,122,122,0,122,0,100,100
732,107-DELHI,210507-Saraswati Shiksha Niketan Inter College,26,122,65,57,0,65,53.28,0
733,109-JAIPUR,M17117-Children Sr.sec.school,33,122,122,0,110,12,100,90.16
734,110-PATNA,030070-+2 M.l.academy,31,122,118,4,91,27,96.72,74.59
735,107-DELHI,270505-Har Govind Secondary Public School,29,122,122,0,122,0,100,100
736,114-DEHRADUN,340243-Govt. Inter College,28,121,93,28,18,75,76.86,14.88
737,109-JAIPUR,170338-Tagore Public Sr.sec. School,25,120,119,1,68,51,99.17,56.67
738,114-DEHRADUN,340296-Scholar Beam Sr. Sec. School,24,120,116,4,116,0,96.67,96.67
739,106-KOCHI,M09109-St. John's Public School,26,119,119,0,112,7,100,94.12
740,106-KOCHI,M09088-Iqra Islamic Women's College,24,119,119,0,119,0,100,100
741,118-GANDHINAGAR,390074-Nootan Bharti Vidyalaya,22,119,119,0,109,10,100,91.6
742,107-DELHI,050366-C.D. International School,26,119,0,119,0,0,0,0
743,107-DELHI,210441-S. V. Vidya Mandir Inter College,26,119,119,0,111,8,100,93.28
744,109-JAIPUR,170109-K R Adarsh Sr.Sec.School,30,119,118,1,107,11,99.16,89.92
745,107-DELHI,050663-Modish Public School,30,119,0,119,0,0,0,0
746,114-DEHRADUN,340236-M.p. Hindu Inter College,27,119,119,0,119,0,100,100
747,109-JAIPUR,M17270-S.k. Green Wood Shikshan Sansthan,23,119,119,0,113,6,100,94.96
748,105-CHANDIGARH,050632-Divine Light Sr. Sec. School,26,119,119,0,101,18,100,84.87
749,107-DELHI,050053-Bal Vikas High School,29,119,119,0,119,0,100,100
750,107-DELHI,050107-T. T. Public School,24,118,0,118,0,0,0,0
751,107-DELHI,050627-Shivalik Educational Academy,26,118,118,0,93,25,100,78.81
752,114-DEHRADUN,340297-Riverain Public School,27,117,117,0,117,0,100,100
753,109-JAIPUR,170204-Raghuraj Academy,29,117,117,0,117,0,100,100
754,118-GANDHINAGAR,040081-M V S High School,23,117,117,0,76,41,100,64.96
755,107-DELHI,270377-Nav Gian Deep Sr. Sec. Public School,25,117,112,5,83,29,95.73,70.94
756,109-JAIPUR,170144-Tilak Bal Mandir Sr.sec.school,22,117,114,3,97,17,97.44,82.91
757,113-BHOPAL,J10004-Central Jail Bhopal,24,117,109,8,85,24,93.16,72.65
758,105-CHANDIGARH,050128-Nalwa Lovely Public School,26,116,116,0,116,0,100,100
759,107-DELHI,050376-Yadav Academy Public High School,25,116,17,99,0,17,14.66,0
760,107-DELHI,270451-Tulip International School,24,116,0,116,0,0,0,0
761,109-JAIPUR,170062-LBS CONVENT SENIOR SECONDARY SCHOOL,25,116,116,0,113,3,100,97.41
762,121-CHENNAI,190112-B.v.m. Global,25,116,108,8,28,80,93.1,24.14
763,118-GANDHINAGAR,390088-Bansidhar Vidyalaya,27,115,115,0,115,0,100,100
764,121-CHENNAI,190029-Kendriya Vidyalaya,30,115,0,115,0,0,0,0
765,104-GUWAHATI,M02060-Maryam Ajmal Woken's College Of,26,115,115,0,115,0,100,100
766,116-VISAKHAPATNAM,010146-Sri Adithya Junior College,21,114,114,0,114,0,100,100
767,103-KOLKATA,230014-Govt. Model Senior Secondary School,23,114,95,19,0,95,83.33,0
768,118-GANDHINAGAR,390112-Shree Krishna Secondary Higher Secondary School,19,114,112,2,98,14,98.25,85.96
769,114-DEHRADUN,340215-Govt. Inter College,25,114,0,114,0,0,0,0
770,103-KOLKATA,230003-Name 5132,23,113,54,59,1,53,47.79,0.88
771,107-DELHI,270479-P.D. Model Senior Secondary School,24,113,0,113,0,0,0,0
772,114-DEHRADUN,M21488-Jamia Farooquia Azizul Uloom,27,112,112,0,112,0,100,100
773,115-BHUBANESWAR,150171-Centurion University Of Technology,24,112,112,0,91,21,100,81.25
774,111-ALLAHABAD/PRAYAGRAJ,210169-Smt. Ram Katori Varshney Inter,25,112,112,0,112,0,100,100
775,121-CHENNAI,190100-Smt. Narbada Devi J. Agarwal,26,112,112,0,110,2,100,98.21
776,106-KOCHI,090070-Jawahar Navodaya Vidyalaya,25,111,111,0,108,3,100,97.3
777,114-DEHRADUN,210763-M.D International School,23,111,111,0,103,8,100,92.79
778,105-CHANDIGARH,160026-Everest Public Sr. Sec. School,26,110,109,1,46,63,99.09,41.82
779,118-GANDHINAGAR,040041-Kendriya Vidyalaya,22,110,110,0,77,33,100,70
780,104-GUWAHATI,020004-Kamrup Academy Hr. Sec. School,26,110,110,0,81,29,100,73.64
781,105-CHANDIGARH,050378-Navyug Shiksha Niketan Sr.Sec.school,27,110,107,3,42,65,97.27,38.18
782,107-DELHI,270528-Yash Vidya Public School,24,109,92,17,92,0,84.4,84.4
783,107-DELHI,"210335-Moolchand Chauhan Public School,",23,109,109,0,109,0,100,100
784,102-PUNE,M38349-Al Ameen English High School,21,108,87,21,57,30,80.56,52.78
785,123-GANGTOK,180017-Govt. Senior Secondary School,27,108,108,0,100,8,100,92.59
786,105-CHANDIGARH,M16060-Rose Mary Convent School,27,108,108,0,106,2,100,98.15
787,104-GUWAHATI,M02076-SL COLLEGIATE HIGH SCHOOL,27,108,108,0,107,1,100,99.07
788,104-GUWAHATI,020069-Pranab Jubilee College,28,108,107,1,85,22,99.07,78.7
789,114-DEHRADUN,340115-Govt. Inter Mediate College,25,108,0,108,0,0,0,0
790,118-GANDHINAGAR,390059-St. Xavier's Social Service Soceity,21,107,107,0,99,8,100,92.52
791,107-DELHI,270068-Kendriya Vidyalaya,23,107,0,107,0,0,0,0
792,107-DELHI,210710-Dolphin Public School,24,107,107,0,107,0,100,100
793,109-JAIPUR,170400-Subodh Vidya Mandir Sr. Sen School,24,106,106,0,102,4,100,96.23
794,105-CHANDIGARH,160019-S.d.girls Sr. Sec. School,25,106,106,0,106,0,100,100
795,107-DELHI,"270389-B.v.m. Model School,",24,106,99,7,2,97,93.4,1.89
796,103-KOLKATA,220075-Sibpur Ambika Hindi High School,23,106,0,106,0,0,0,0
797,105-CHANDIGARH,160080-Malwa Sr.secondary School,25,106,106,0,106,0,100,100
798,113-BHOPAL,M10091-Maulana Azad Inst. Of Professional,19,105,101,4,56,45,96.19,53.33
799,105-CHANDIGARH,050573-CHARAN SINGH MEMORIAL CONVENT SR. SEC. SCHOOL,21,105,105,0,105,0,100,100
800,107-DELHI,270515-SHAHEED UDHAM SINGH SAMARAK CO-ED SEC. SCHOOL,21,105,105,0,105,0,100,100
801,106-KOCHI,M09073-Mcf Public School,21,105,105,0,105,0,100,100
802,120-RANCHI,260100-Jamshedpur Balika Ucch Vidyalaya,21,105,0,105,0,0,0,0
803,104-GUWAHATI,020050-Jawahar Navodaya Vidyalaya,27,105,105,0,96,9,100,91.43
804,109-JAIPUR,170050-Saraswati Bal Higher Sec. School,21,104,104,0,104,0,100,100
805,117-BENGALURU,M08047-Karunya Independent Pu College,20,104,104,0,84,20,100,80.77
806,107-DELHI,210243-Anamika Girls Hr. Sec. School,20,104,104,0,104,0,100,100
807,110-PATNA,"030288-B.n.collegiate School,",24,104,75,29,12,63,72.12,11.54
808,104-GUWAHATI,120023-Sentinel College,21,104,104,0,101,3,100,97.12
809,123-GANGTOK,180009-Govt. Senior Secondary School,23,104,104,0,104,0,100,100
810,118-GANDHINAGAR,040093-Sanskartirth Gyanpeeth,23,104,104,0,99,5,100,95.19
811,114-DEHRADUN,340117-Swatantrata Sangram Senani Shaheed,22,104,104,0,103,1,100,99.04
812,109-JAIPUR,170398-Bhairav Public Sr. Sec. School,21,103,103,0,82,21,100,79.61
813,105-CHANDIGARH,050215-Holy Heart Sec School,21,103,102,1,26,76,99.03,25.24
814,105-CHANDIGARH,050589-Modern Hind Sr. Sec. School,23,103,103,0,43,60,100,41.75
815,102-PUNE,110126-SAILEE INTERNATIONAL SCHOOL  & JUNIOR COLLEGE,24,103,103,0,99,4,100,96.12
816,114-DEHRADUN,V34001-Doon Vadic Shiksha Samiti,21,103,32,71,29,3,31.07,28.16
817,106-KOCHI,"400001-Progressive English School,",20,102,102,0,25,77,100,24.51
818,114-DEHRADUN,340190-Shri Ravi Dutt Bahuguna High School,22,102,102,0,102,0,100,100
819,107-DELHI,050212-Bhartiya Vidya Niketan Sr.s.school,23,102,0,102,0,0,0,0
820,105-CHANDIGARH,160108-Fortune Convent Sr. Sec. School,22,102,101,1,101,0,99.02,99.02
821,109-JAIPUR,170086-Adarsh Jyoti Vidya Peeth,23,101,101,0,86,15,100,85.15
822,108-ABROAD/NIOS HQ,950028-Kuwait Educational Centre,25,101,0,101,0,0,0,0
823,120-RANCHI,"260067-D.a.v. Model School,",23,101,101,0,76,25,100,75.25
824,109-JAIPUR,170438-Shri Ravinder Nath Tagore Sr. Sec. School,23,101,101,0,90,11,100,89.11
825,107-DELHI,270458-Heera Lal Public School,19,101,0,101,0,0,0,0
826,104-GUWAHATI,300001-Madonna Education Centre,23,101,99,2,74,25,98.02,73.27
827,109-JAIPUR,170330-Vivekanand Senior Secondary School,23,101,101,0,100,1,100,99.01
828,102-PUNE,110077-Sri Ma Vidyalaya Patilpada,32,101,97,4,95,2,96.04,94.06
829,118-GANDHINAGAR,390127-Adwait Vidyamandir Jasara,18,100,100,0,93,7,100,93
830,111-ALLAHABAD/PRAYAGRAJ,M21474-Shuaib Mohammedia Anglo Oriental,26,100,90,10,48,42,90,48
831,125-JAMMU,070054-Prashant Public High School,23,100,100,0,100,0,100,100
832,114-DEHRADUN,340124-A.n. Jha Govt. Inter College,23,100,0,100,0,0,0,0
833,104-GUWAHATI,M02063-Durabandhi Secondary School,25,100,100,0,100,0,100,100
834,103-KOLKATA,220127-Pearl Rosary School (New),20,100,100,0,73,27,100,73
835,107-DELHI,270543-Himalaya Public Sr. Secondary School,20,99,0,99,0,0,0,0
836,107-DELHI,M27233-Baba Banda Singh Memo. Sec. School,18,99,0,99,0,0,0,0
837,106-KOCHI,400062-Vimla Hridya Icse School,20,99,99,0,98,1,100,98.99
838,125-JAMMU,070001-Presentation Convent High School,23,99,79,20,43,36,79.8,43.43
839,105-CHANDIGARH,050619-Oxford Public School,22,99,97,2,14,83,97.98,14.14
840,102-PUNE,110012-Sandesh Vidyalaya College Of Arts,21,99,99,0,99,0,100,100
841,114-DEHRADUN,340227-Govt. Inter College,21,99,99,0,99,0,100,100
842,115-BHUBANESWAR,410121-Kendriya Vidyalaya,21,99,93,6,54,39,93.94,54.55
843,118-GANDHINAGAR,390108-P R Mukhi Sec. & Hr. Sec. School,21,98,98,0,73,25,100,74.49
844,114-DEHRADUN,340257-Govt. Inter College,21,98,0,98,0,0,0,0
845,107-DELHI,270417-Navyug Convent School,21,97,97,0,97,0,100,100
846,107-DELHI,270492-Adarsh GyanSarover Balika Vidyalaya,21,97,97,0,90,7,100,92.78
847,107-DELHI,"450077-DEEPALAYA Y/4A,",20,97,0,97,0,0,0,0
848,107-DELHI,210771-Diamond Public School,19,97,96,1,77,19,98.97,79.38
849,105-CHANDIGARH,050522-Guru Nanak Sr.Sec.School,21,97,97,0,64,33,100,65.98
850,105-CHANDIGARH,J05004-District Jail,19,97,97,0,28,69,100,28.87
851,115-BHUBANESWAR,410119-The Assembly Of God School,17,96,96,0,53,43,100,55.21
852,105-CHANDIGARH,050662-Indus Public School,22,96,96,0,69,27,100,71.88
853,109-JAIPUR,170430-Gayatri Sr. Sec. School,21,96,94,2,55,39,97.92,57.29
854,107-DELHI,210671-Konark Public School,21,96,0,96,0,0,0,0
855,106-KOCHI,400053-Kendriya Vidyalaya,20,96,96,0,96,0,100,100
856,102-PUNE,110145-Akshara International School,29,96,94,2,46,48,97.92,47.92
857,115-BHUBANESWAR,T15010-Centurian Private ITI,48,96,96,0,75,21,100,78.13
858,103-KOLKATA,220048-Kendriya Vidyalaya No. 2,22,96,96,0,96,0,100,100
859,114-DEHRADUN,M34252-Jamia Islahul Banaat,16,95,82,13,75,7,86.32,78.95
860,104-GUWAHATI,020039-Kendriya Vidyalaya,25,95,92,3,66,26,96.84,69.47
861,125-JAMMU,380108-Govt. Boys Higher Secondary School,21,95,95,0,88,7,100,92.63
862,118-GANDHINAGAR,040007-Tree House High School,21,95,95,0,60,35,100,63.16
863,107-DELHI,270260-Sant Hari Dass Public School,23,95,1,94,0,1,1.05,0
864,106-KOCHI,M40063-Mao Higher Secondary School Elayur,27,95,95,0,95,0,100,100
865,101-HYDERABAD,"370109-T.s.w.r.school Jr.college(g),",19,95,95,0,95,0,100,100
866,106-KOCHI,400043-Kendriya Vidyalaya No-2,19,95,95,0,95,0,100,100
867,114-DEHRADUN,340303-North Point Children's Academy,20,95,95,0,93,2,100,97.89
868,105-CHANDIGARH,050440-K.n.senior Secondary School,21,94,94,0,94,0,100,100
869,121-CHENNAI,190027-The Vikasa School,20,94,89,5,59,30,94.68,62.77
870,107-DELHI,270490-Hansraj Model School,20,94,94,0,94,0,100,100
871,106-KOCHI,400046-Kendriya Vidyalaya No-1,21,94,94,0,80,14,100,85.11
872,107-DELHI,270546-N L Public School,21,94,94,0,94,0,100,100
873,125-JAMMU,070002-Kendriya Vidyalaya No.1,23,93,22,71,13,9,23.66,13.98
874,104-GUWAHATI,300019-Govt. Higher Secondary School,22,93,84,9,84,0,90.32,90.32
875,118-GANDHINAGAR,"040013-Seth C.l. Hindi High School,",24,93,93,0,78,15,100,83.87
876,107-DELHI,270538-Rama Public School,19,93,90,3,88,2,96.77,94.62
877,107-DELHI,270525-G R M Public School,18,93,61,32,44,17,65.59,47.31
878,107-DELHI,270460-New Sandhya Public School,19,93,72,21,72,0,77.42,77.42
879,103-KOLKATA,220017-Shree Jain Shilpa Shiksha Kendra,18,93,8,85,8,0,8.6,8.6
880,109-JAIPUR,170358-Kids Club School,23,93,93,0,71,22,100,76.34
881,109-JAIPUR,M38350-Al Suffah Academy Public School,23,92,92,0,92,0,100,100
882,107-DELHI,210595-Unique International Public School,20,92,92,0,82,10,100,89.13
883,114-DEHRADUN,210438-Tagore Vidya Peeth Inter College,20,92,92,0,92,0,100,100
884,120-RANCHI,260084-Vimla Pandey Memorial Gyan Niketan,18,92,92,0,5,87,100,5.43
885,105-CHANDIGARH,M05113-G.t.b. Bal Vidya Mandir Sr.s.school,18,91,91,0,76,15,100,83.52
886,114-DEHRADUN,340286-Aryan Vidya Mandir,24,91,91,0,90,1,100,98.9
887,109-JAIPUR,170167-Govt. Higher Secondary School,20,91,81,10,36,45,89.01,39.56
888,114-DEHRADUN,210672-Dev Krishna Public School,19,91,90,1,77,13,98.9,84.62
889,114-DEHRADUN,340171-City Public Inter College,25,91,83,8,83,0,91.21,91.21
890,109-JAIPUR,M17262-Khawaja Model School,18,90,85,5,73,12,94.44,81.11
891,118-GANDHINAGAR,M04016-St. Xavier's High School,21,90,90,0,68,22,100,75.56
892,121-CHENNAI,190022-The Gandhi Gram Rural Institute,19,90,88,2,77,11,97.78,85.56
893,105-CHANDIGARH,050148-Saraswati Vidya Mandir High School,19,90,90,0,90,0,100,100
894,114-DEHRADUN,210804-Paramount Public School,20,89,89,0,89,0,100,100
895,118-GANDHINAGAR,040058-Nib School Of Science,17,89,89,0,64,25,100,71.91
896,105-CHANDIGARH,160137-Paragon Sr. Sec. School,20,89,89,0,33,56,100,37.08
897,115-BHUBANESWAR,410140-Jawahar  Navodaya Vidyalaya,21,88,85,3,59,26,96.59,67.05
898,111-ALLAHABAD/PRAYAGRAJ,210658-Kalawati Inter College,23,88,88,0,72,16,100,81.82
899,117-BENGALURU,080071-Patel Pre-University College,19,88,88,0,43,45,100,48.86
900,114-DEHRADUN,340298-Adarsh Inter College,20,88,0,88,0,0,0,0
901,102-PUNE,M11084-Sir Sayyad English High School,18,88,88,0,88,0,100,100
902,105-CHANDIGARH,160141-Shri Deshmesh Public Sr.Sec.School,17,88,88,0,62,26,100,70.45
903,109-JAIPUR,"170200-Govt. Hr. Sec. School, Chittorgarh",18,88,83,5,26,57,94.32,29.55
904,107-DELHI,270503-GYAN SAROVER SEC. BAL VIDYALAYA,21,88,88,0,88,0,100,100
905,104-GUWAHATI,020024-Kendriya Vidyalaya,21,88,88,0,88,0,100,100
906,114-DEHRADUN,M21354-Ahmed Saeed Khan Rifahe Aam Inter,20,88,88,0,72,16,100,81.82
907,107-DELHI,270269-Happy Senior School,22,87,84,3,31,53,96.55,35.63
908,106-KOCHI,400028-Sree Valluvanad Vidya Bhavan,19,87,87,0,84,3,100,96.55
909,114-DEHRADUN,210251-Agroha Shiksha Niketan Inter,19,87,0,87,0,0,0,0
910,119-RAIPUR,290094-Govt. Boys Higher Secondary School,18,87,58,29,21,37,66.67,24.14
911,118-GANDHINAGAR,040001-St.xavier's Social Service Society,20,87,86,1,60,26,98.85,68.97
912,115-BHUBANESWAR,410138-410138-BRAJENDRA HIGH SCHOOL,18,86,85,1,56,29,98.84,65.12
913,103-KOLKATA,220033-Kendriya Vidyalaya,23,86,86,0,53,33,100,61.63
914,111-ALLAHABAD/PRAYAGRAJ,210172-Gayatri Samarak Public School,17,86,85,1,83,2,98.84,96.51
915,107-DELHI,"J05281-District Jail, Faridabad",21,86,0,86,0,0,0,0
916,114-DEHRADUN,340087-Maharishi Vidya Mandir,19,86,86,0,86,0,100,100
917,121-CHENNAI,190109-Maharishi Vidya Mandir Senior,31,85,80,5,74,6,94.12,87.06
918,111-ALLAHABAD/PRAYAGRAJ,210316-Maa Shri Mahakali Inter College,21,85,85,0,58,27,100,68.24
919,109-JAIPUR,170160-Gcm Govt. Hr. Sec. School,17,85,85,0,39,46,100,45.88
920,105-CHANDIGARH,050638-Rising Sun Public School,18,85,84,1,21,63,98.82,24.71
921,121-CHENNAI,420089-The Vikasa School,17,85,0,85,0,0,0,0
922,106-KOCHI,400045-Vyas Vidyaniketan Central School,19,85,85,0,84,1,100,98.82
923,105-CHANDIGARH,050381-Sunshine Public School,18,85,85,0,42,43,100,49.41
924,115-BHUBANESWAR,410122-Oriental Public School,14,85,81,4,53,28,95.29,62.35
925,107-DELHI,210733-Bal Jagat Sr.Sec. School,17,84,84,0,84,0,100,100
926,107-DELHI,270324-EKTA MODEL SECONDARY SCHOOL,16,84,78,6,78,0,92.86,92.86
927,115-BHUBANESWAR,410148-Name 5103,16,84,84,0,74,10,100,88.1
928,107-DELHI,210203-Swami Vivekanandsaraswatividyalaya,16,84,83,1,68,15,98.81,80.95
929,105-CHANDIGARH,050551-Thukral Public Sr. Sec. School ,18,84,84,0,76,8,100,90.48
930,125-JAMMU,070008-Govt. Girls Higher Secondary School,19,83,15,68,1,14,18.07,1.2
931,107-DELHI,210334-ROCKWOOD SCHOOL,19,83,79,4,64,15,95.18,77.11
932,106-KOCHI,M40055-M.t.i Central School Pottachira,17,83,83,0,68,15,100,81.93
933,106-KOCHI,090087-Raja Rajeswari Senior Sec.school,17,83,83,0,81,2,100,97.59
934,114-DEHRADUN,340219-Ashu Public Inter College,19,83,83,0,69,14,100,83.13
935,111-ALLAHABAD/PRAYAGRAJ,210380-Bal Niketan Balika Inter College,18,83,69,14,16,53,83.13,19.28
936,103-KOLKATA,460288-Lakhuria High School,17,83,0,83,0,0,0,0
937,105-CHANDIGARH,050654-Satluj Public School,18,83,83,0,83,0,100,100
938,106-KOCHI,400041-Kendriya Vidyalaya,21,82,82,0,74,8,100,90.24
939,120-RANCHI,260074-Dav Public School,19,82,0,82,0,0,0,0
940,108-ABROAD/NIOS HQ,970002-Shantiniketan Indian School,18,82,82,0,81,1,100,98.78
941,102-PUNE,M11129-Reena Mehta College,17,82,82,0,82,0,100,100
942,109-JAIPUR,170388-Sanskar Public Sr.Sec. School,17,81,81,0,81,0,100,100
943,105-CHANDIGARH,M16073-Guru Nanak Convent Sen. Sec. School,18,81,81,0,81,0,100,100
944,105-CHANDIGARH,M05090-Ilyas Public School,21,81,81,0,81,0,100,100
945,120-RANCHI,260086-Jawahar Navodaya Vidyalaya,20,81,2,79,0,2,2.47,0
946,107-DELHI,M21209-Azad Memorial Inter College,18,81,0,81,0,0,0,0
947,105-CHANDIGARH,050078-Buniyad Senior Secondary School,18,81,81,0,77,4,100,95.06
948,114-DEHRADUN,210280-Mansarover Girls Inter College,21,80,80,0,72,8,100,90
949,121-CHENNAI,190156-DAV Boys Sr. Secondary School,20,80,80,0,69,11,100,86.25
950,107-DELHI,050221-VIVEK VIDYA SADAN SR.SEC SCHOOL,17,80,0,80,0,0,0,0
951,106-KOCHI,M40034-Crescent Rsidential Higher,20,80,79,1,30,49,98.75,37.5
952,105-CHANDIGARH,050387-Rao Jai Ram Sr.sec. School,16,80,80,0,80,0,100,100
953,117-BENGALURU,080075-Sindhi High School,19,79,79,0,79,0,100,100
954,103-KOLKATA,220100-Kankinara Himayatul Ghurba,15,79,76,3,74,2,96.2,93.67
955,113-BHOPAL,100196-Abhyuday Sr. Sec. School,19,79,78,1,77,1,98.73,97.47
956,105-CHANDIGARH,160120-NRI Public School,18,79,79,0,77,2,100,97.47
957,106-KOCHI,M40010-Ansar English School,17,79,79,0,29,50,100,36.71
958,118-GANDHINAGAR,390119-Shree Aditya Secondary & High School,17,79,79,0,61,18,100,77.22
959,114-DEHRADUN,340069-Kendriya Vidyalaya,19,79,79,0,79,0,100,100
960,114-DEHRADUN,M34255-RAMSAY INTER COLLEGE,20,78,68,10,68,0,87.18,87.18
961,105-CHANDIGARH,050480-Saraswati High School,20,78,78,0,78,0,100,100
962,125-JAMMU,380266-Srinagar Group of Schools,19,78,2,76,0,2,2.56,0
963,114-DEHRADUN,340202-Government Inter College,17,78,78,0,78,0,100,100
964,121-CHENNAI,190116-Lakshmi Garden Matric Hr.Sec.School,16,78,73,5,47,26,93.59,60.26
965,106-KOCHI,M40031-Mar Ivonios Bethany School,16,78,78,0,45,33,100,57.69
966,114-DEHRADUN,M38366-Mesco Public School,19,78,78,0,78,0,100,100
967,105-CHANDIGARH,160036-Suman Dav-boarding Public School,16,78,77,1,77,0,98.72,98.72
968,114-DEHRADUN,340212-Kendriya Vidyalaya,17,78,0,78,0,0,0,0
969,120-RANCHI,260077-Kerala Public School,15,77,74,3,7,67,96.1,9.09
970,110-PATNA,030071-S.n.singh Dev. N.g.,18,77,58,19,5,53,75.32,6.49
971,109-JAIPUR,170397-Lo.Ti. Sr.Sec. School,15,77,75,2,28,47,97.4,36.36
972,114-DEHRADUN,340294-Guru Nanak Mission Public School,18,77,58,19,57,1,75.32,74.03
973,107-DELHI,210716-Milton Academy Jr. High School,15,77,76,1,5,71,98.7,6.49
974,109-JAIPUR,170318-Sant Vidya Nand Sr.sec.sch.& Hostel,17,77,77,0,77,0,100,100
975,107-DELHI,450019-Amar Jyoti Rehablitation & Research,20,77,72,5,33,39,93.51,42.86
976,107-DELHI,270534-R M Arya Girls Sr. Secondary School,17,77,71,6,69,2,92.21,89.61
977,120-RANCHI,260042-Subhash Public School,20,77,74,3,74,0,96.1,96.1
978,105-CHANDIGARH,M16112-SOHRAB PUBLIC SCHOOL ,16,76,74,2,55,19,97.37,72.37
979,106-KOCHI,400049-Kendriya Vidyalaya,17,76,76,0,76,0,100,100
980,105-CHANDIGARH,050332-Sunrise Modern School,18,76,75,1,15,60,98.68,19.74
981,125-JAMMU,070015-Govt. Boys Higher Secondary School,19,76,76,0,76,0,100,100
982,122-DHARAMSALA,060083-Blue Star Public Sr.sec. School,17,76,61,15,48,13,80.26,63.16
983,109-JAIPUR,170413-Saraswati Vidya Mandir Sr. Sec. School,15,75,75,0,61,14,100,81.33
984,125-JAMMU,070055-Shishu Niketan Sr. Sec. School,17,75,61,14,50,11,81.33,66.67
985,103-KOLKATA,220124-Durgapur Iswar Chandra Vidyasagar (DICV) Public School,17,75,73,2,66,7,97.33,88
986,106-KOCHI,400039-Kendriya Vidyalaya,16,75,75,0,75,0,100,100
987,111-ALLAHABAD/PRAYAGRAJ,210479-Shri Sovaran Singh Ratani Devi,19,75,75,0,6,69,100,8
988,105-CHANDIGARH,050570-SHRI KRISHAN PUBLIC SCHOOL,18,75,75,0,49,26,100,65.33
989,121-CHENNAI,190127-B.V.M. Global,16,75,72,3,44,28,96,58.67
990,102-PUNE,M11018-Guru Govind Singh Public School,15,75,75,0,69,6,100,92
991,121-CHENNAI,190107-KH MATRICULATION BOYS HR. SEC. SCHOOL`,16,74,74,0,71,3,100,95.95
992,106-KOCHI,M40036-Mar Dionysius Sr.sec.school,16,74,74,0,59,15,100,79.73
993,103-KOLKATA,220122-Aaloke Bharti Model School,16,74,0,74,0,0,0,0
994,106-KOCHI,M40068-Infant Jesus Residential School,17,74,74,0,53,21,100,71.62
995,121-CHENNAI,190104-Lalaji Memorial Omega International,39,74,74,0,73,1,100,98.65
996,114-DEHRADUN,340198-Govt. Inter College damta,19,74,74,0,74,0,100,100
997,103-KOLKATA,230007-Govt. Senior Secondary School,13,74,72,2,70,2,97.3,94.59
998,123-GANGTOK,450043-Raphael Academic & Voc. School,17,74,63,11,0,63,85.14,0
999,109-JAIPUR,170301-Ramnivas Vidya Mandir Sr.sec.school,15,74,74,0,74,0,100,100
1000,107-DELHI,270425-Mount Abu Public School,16,73,73,0,71,2,100,97.26
1001,118-GANDHINAGAR,390120-Maharshi Vidhyalaya,14,73,73,0,50,23,100,68.49
1002,106-KOCHI,"400023-Labour India Public School,",17,73,73,0,35,38,100,47.95
1003,107-DELHI,270122-PUSA PUBLIC SR.SEC.SCHOOL,14,73,51,22,51,0,69.86,69.86
1004,102-PUNE,110085-Dr.kalmadi Shamarao High School,20,73,73,0,62,11,100,84.93
1005,106-KOCHI,400019-Mahatma Gandhi Public School,14,73,73,0,62,11,100,84.93
1006,107-DELHI,270242-M.n.convent Sr.sec.school,17,73,0,73,0,0,0,0
1007,105-CHANDIGARH,050442-Golden Crescent Public School,17,72,72,0,18,54,100,25
1008,107-DELHI,210289-C.c.s Vidya Mandir Girl's,14,72,72,0,32,40,100,44.44
1009,114-DEHRADUN,340167-Sanjay Public Intermediate College,11,72,0,72,0,0,0,0
1010,114-DEHRADUN,210246-R.s.d. Academy Public School,15,72,72,0,72,0,100,100
1011,105-CHANDIGARH,160016-Rabindra Day Boarding Ss.pub.school,15,72,72,0,71,1,100,98.61
1012,114-DEHRADUN,340142-M.d. Inter College,16,72,0,72,0,0,0,0
1013,109-JAIPUR,170276-Shri Bhagwati Vaidya Mandir,13,72,72,0,72,0,100,100
1014,118-GANDHINAGAR,390087-Janki Vidyalaya,20,71,71,0,60,11,100,84.51
1015,115-BHUBANESWAR,150174-Town High School,11,71,71,0,65,6,100,91.55
1016,107-DELHI,210649-S.b.n. Public School,17,71,0,71,0,0,0,0
1017,107-DELHI,050316-S.r. Sr.sec. School,15,71,70,1,70,0,98.59,98.59
1018,121-CHENNAI,190125-Blossom Public School,15,71,70,1,69,1,98.59,97.18
1019,110-PATNA,"030329-Rajkiya +2 High School,",14,71,48,23,12,36,67.61,16.9
1020,107-DELHI,210096-Saraswati Bal Mandir Sr.sec.school,15,71,0,71,0,0,0,0
1021,107-DELHI,270219-Kendriya Vidylaya,18,70,6,64,6,0,8.57,8.57
1022,107-DELHI,450072-Prayas Juvenile Aid Centre,17,70,17,53,1,16,24.29,1.43
1023,106-KOCHI,090100-Siddartha Central School,15,70,70,0,68,2,100,97.14
1024,107-DELHI,050190-S.d.modern Sr.sec.school,15,70,0,70,0,0,0,0
1025,114-DEHRADUN,M38358-Madarsa Islahul Muslimeen,19,70,70,0,70,0,100,100
1026,104-GUWAHATI,130008-Mizo Modern High School,16,70,70,0,32,38,100,45.71
1027,115-BHUBANESWAR,410146-Chitalo Mohavidyalaya,14,70,58,12,36,22,82.86,51.43
1028,120-RANCHI,260032-St. Xaviers High School,14,69,69,0,69,0,100,100
1029,108-ABROAD/NIOS HQ,950012-My Capital Educational Facilities Management Facilities Management,15,69,69,0,69,0,100,100
1030,110-PATNA,030074-Zila School,15,69,48,21,8,40,69.57,11.59
1031,114-DEHRADUN,340169-Saigrace Academy International,16,69,9,60,0,9,13.04,0
1032,101-HYDERABAD,M47019-Al-Ameen Jr. Degree College,21,68,68,0,68,0,100,100
1033,115-BHUBANESWAR,J15165-Spl. Jail Bhubaneswar,14,68,59,9,45,14,86.76,66.18
1034,104-GUWAHATI,020065-KENDRIYA VIDYALAYA,15,67,66,1,41,25,98.51,61.19
1035,123-GANGTOK,180001-Govt. Senior Secondary School,15,67,66,1,50,16,98.51,74.63
1036,110-PATNA,030368-Jawahar Navodaya Vidyalaya,15,67,67,0,67,0,100,100
1037,102-PUNE,110073-Symbiosis,19,66,66,0,66,0,100,100
1038,107-DELHI,270554-G R International School,18,66,55,11,51,4,83.33,77.27
1039,105-CHANDIGARH,J05282-Central Jail,14,66,66,0,20,46,100,30.3
1040,107-DELHI,210715-J.P. International School,14,66,0,66,0,0,0,0
1041,119-RAIPUR,290169-Colonel's Academy of Radiant Education,13,66,66,0,0,66,100,0
1042,120-RANCHI,260045-Pvss Dav Public School,14,66,5,61,0,5,7.58,0
1043,117-BENGALURU,080027-National Public High School,17,66,66,0,36,30,100,54.55
1044,103-KOLKATA,450028-M.k.r.&r.indtit For The Handicapped,15,66,50,16,0,50,75.76,0
1045,106-KOCHI,"400018-Darussalam English School,",14,65,65,0,13,52,100,20
1046,109-JAIPUR,170324-L.b.s. Academy Sr.sec. School,12,65,65,0,64,1,100,98.46
1047,105-CHANDIGARH,050524-Adarsh Senior Secondary School,14,65,65,0,65,0,100,100
1048,120-RANCHI,260180-+2 High School,13,65,64,1,61,3,98.46,93.85
1049,111-ALLAHABAD/PRAYAGRAJ,210539-Oxford Public School,16,65,56,9,13,43,86.15,20
1050,118-GANDHINAGAR,040095-Maharshi Vidhyalaya,13,65,65,0,46,19,100,70.77
1051,107-DELHI,270435-Bal Vidya Model School,14,65,64,1,59,5,98.46,90.77
1052,103-KOLKATA,220014-Caesar School,13,64,0,64,0,0,0,0
1053,104-GUWAHATI,200019-Melagarh H.s.school,13,64,64,0,51,13,100,79.69
1054,107-DELHI,270423-Aryan International School,14,64,0,64,0,0,0,0
1055,118-GANDHINAGAR,390118-Ankur Vidhyalaya,13,64,64,0,64,0,100,100
1056,108-ABROAD/NIOS HQ,910001-International Indian School,13,64,64,0,63,1,100,98.44
1057,121-CHENNAI,310009-Aditya Vidhyashram Residential Sch.,13,63,44,19,11,33,69.84,17.46
1058,107-DELHI,270465-R.P. Memorial Public Sr.Sec.School,15,63,62,1,38,24,98.41,60.32
1059,115-BHUBANESWAR,150194-Centurian University Of Technology,13,63,63,0,39,24,100,61.9
1060,116-VISAKHAPATNAM,010175-Sri Sai Baba Junior College,11,63,62,1,62,0,98.41,98.41
1061,106-KOCHI,400021-T.k.m Higher Sec.school,12,63,63,0,39,24,100,61.9
1062,105-CHANDIGARH,160159-Dashmesh Sr. Sec. School,15,63,63,0,63,0,100,100
1063,110-PATNA,"030249-V.m. Inter College,",13,62,62,0,62,0,100,100
1064,114-DEHRADUN,210208-Muslim Inter College,13,62,60,2,60,0,96.77,96.77
1065,107-DELHI,270517-M R BhartiModel Sr. Secondary School,13,62,62,0,0,62,100,0
1066,102-PUNE,110064-The Lord's English High School,17,62,61,1,54,7,98.39,87.1
1067,109-JAIPUR,170308-Vivek Vidhya Mandir Sr.sec.school,13,62,62,0,62,0,100,100
1068,111-ALLAHABAD/PRAYAGRAJ,210540-Shree Mahaprabhu Public School,15,62,62,0,62,0,100,100
1069,106-KOCHI,090024-Trinity Lyceum,14,62,62,0,44,18,100,70.97
1070,110-PATNA,030276-Patna High School +2,15,62,43,19,2,41,69.35,3.23
1071,107-DELHI,270407-Modern New Delhi Public School,14,62,62,0,62,0,100,100
1072,107-DELHI,450060-National Association For The Blind,15,62,62,0,62,0,100,100
1073,105-CHANDIGARH,160066-Pine Grove Public School,15,62,62,0,46,16,100,74.19
1074,104-GUWAHATI,"020017-Diphu Commercial College,",14,62,61,1,27,34,98.39,43.55
1075,118-GANDHINAGAR,040055-Janki Vidyalaya,14,61,60,1,51,9,98.36,83.61
1076,115-BHUBANESWAR,150013-The Assembly Of God School,12,61,61,0,32,29,100,52.46
1077,107-DELHI,270129-Prerana Public Secondary School,13,61,0,61,0,0,0,0
1078,104-GUWAHATI,440007-Doomdooma Junior College,14,61,59,2,49,10,96.72,80.33
1079,113-BHOPAL,100076-Akshay Academy Hr. Secondary School,15,61,0,61,0,0,0,0
1080,104-GUWAHATI,130014-Kendriya Vidyalaya,15,61,61,0,58,3,100,95.08
1081,111-ALLAHABAD/PRAYAGRAJ,210537-Jamuna Prasad Girls Inter College,14,61,61,0,61,0,100,100
1082,107-DELHI,270520-Sevti Devi Memorial Vidya Mandir,14,61,2,59,1,1,3.28,1.64
1083,105-CHANDIGARH,160039-Jamuna Model Sr. Sec. School,14,60,60,0,60,0,100,100
1084,106-KOCHI,M09100-MGM CENTRAL SCHOOL,14,60,60,0,36,24,100,60
1085,103-KOLKATA,M22097-Chachanda B.j. High School,10,60,60,0,60,0,100,100
1086,105-CHANDIGARH,250013-Aanchal International School,19,60,59,1,39,20,98.33,65
1087,118-GANDHINAGAR,040003-Asoplav Nidhi,14,60,59,1,44,15,98.33,73.33
1088,104-GUWAHATI,M30011-Sacred Heart School,15,60,60,0,44,16,100,73.33
1089,107-DELHI,270310-Bharat Shakti Public School,13,60,60,0,60,0,100,100
1090,105-CHANDIGARH,160035-F.s. Mann Silver Greek School,13,60,60,0,53,7,100,88.33
1091,110-PATNA,M03114-Red Carpet High School,14,59,59,0,10,49,100,16.95
1092,115-BHUBANESWAR,150195-Suddhananda Vidyalaya,12,59,54,5,28,26,91.53,47.46
1093,104-GUWAHATI,140032-Govt. Higher Secondary school,14,59,59,0,47,12,100,79.66
1094,117-BENGALURU,080003-Don Bosco Academy,15,59,59,0,38,21,100,64.41
1095,102-PUNE,280006-Dr. Sakha Ram Gude High School,11,59,59,0,48,11,100,81.36
1096,103-KOLKATA,230008-Govt. Senior Secondary School,11,59,58,1,39,19,98.31,66.1
1097,107-DELHI,270535-Little Star Convent School,14,59,2,57,2,0,3.39,3.39
1098,110-PATNA,030265-Shersahsuri Ucch Madhyamik,16,59,50,9,4,46,84.75,6.78
1099,120-RANCHI,260121-Rajkiya Krit +2 High School,13,59,0,59,0,0,0,0
1100,101-HYDERABAD,470072-I.s.o. Jr. College,14,58,58,0,58,0,100,100
1101,118-GANDHINAGAR,040105-Shree Swaminarayan English Medium School,13,58,58,0,23,35,100,39.66
1102,109-JAIPUR,"170253-Kendriya  Vidyalaya No.3,",13,58,55,3,52,3,94.83,89.66
1103,117-BENGALURU,080079-M.V.J International School,15,58,57,1,45,12,98.28,77.59
1104,105-CHANDIGARH,050566-KOYAL PUBLIC SR. SEC. SCHOOL,15,58,58,0,54,4,100,93.1
1105,106-KOCHI,350001-Kendriya Vidyalaya,11,57,57,0,19,38,100,33.33
1106,102-PUNE,M11132-Kaiser College of Commerce,12,57,57,0,52,5,100,91.23
1107,118-GANDHINAGAR,040017-Gracious English School,12,57,57,0,57,0,100,100
1108,103-KOLKATA,230001-Govt. Model Sr. Sec. School,13,57,0,57,0,0,0,0
1109,119-RAIPUR,290172-J R DANI GOVT. GR HR. SEC SCHOOL,13,57,4,53,0,4,7.02,0
1110,114-DEHRADUN,M34238-Shri Guru Nanak Academy,12,57,0,57,0,0,0,0
1111,114-DEHRADUN,"450104-Vaani School And Research Centre,",14,57,57,0,57,0,100,100
1112,125-JAMMU,070039-Jawahar Navodaya Vidyalaya,12,57,13,44,0,13,22.81,0
1113,114-DEHRADUN,210121-Islamia Inter College,14,57,57,0,57,0,100,100
1114,111-ALLAHABAD/PRAYAGRAJ,210723-Army Public School,14,57,27,30,18,9,47.37,31.58
1115,109-JAIPUR,320609-HQ 24 Rapid,12,57,56,1,52,4,98.25,91.23
1116,111-ALLAHABAD/PRAYAGRAJ,210158-St.andrews High School,12,57,57,0,53,4,100,92.98
1117,114-DEHRADUN,340193-U.s.r. Indu Inter College,10,57,3,54,0,3,5.26,0
1118,107-DELHI,270202-Shiksha Bharti Public School,12,56,0,56,0,0,0,0
1119,106-KOCHI,090069-Jawahar Navodaya Vidyalaya,11,56,56,0,39,17,100,69.64
1120,105-CHANDIGARH,160074-Aadharshila The Foundation,14,56,56,0,17,39,100,30.36
1121,104-GUWAHATI,020026-Kendriya Vidyalaya,13,56,55,1,41,14,98.21,73.21
1122,105-CHANDIGARH,050613-Sardar Vallabh Bhai Public School,13,56,56,0,56,0,100,100
1123,109-JAIPUR,170275-Supreme Bal Bharti Sr.sec.school,12,56,56,0,55,1,100,98.21
1124,111-ALLAHABAD/PRAYAGRAJ,M38273-National Public Inter College,12,56,26,30,3,23,46.43,5.36
1125,117-BENGALURU,080076-Delhi Public School,13,56,56,0,55,1,100,98.21
1126,109-JAIPUR,170002-New Look Central School,12,56,54,2,54,0,96.43,96.43
1127,104-GUWAHATI,"020047-Kendriya Vidyalaya, Crpf,",13,55,54,1,42,12,98.18,76.36
1128,111-ALLAHABAD/PRAYAGRAJ,210030-Kendriya Vidyalaya No.1 AFS Chakeri Kanpur,14,55,39,16,15,24,70.91,27.27
1129,114-DEHRADUN,340111-Govt. Intermediate College,13,55,55,0,0,55,100,0
1130,107-DELHI,270464-M.d. Memorial Sec. Public School,11,55,53,2,53,0,96.36,96.36
1131,114-DEHRADUN,340031-Kendriya Vidyalaya No.1,12,55,0,55,0,0,0,0
1132,113-BHOPAL,100080-Adarsh Higher Sec.school,11,55,0,55,0,0,0,0
1133,114-DEHRADUN,340177-Tharu Govt. Inter College,13,55,55,0,47,8,100,85.45
1134,120-RANCHI,260198-Saraswati Vidya Mandir,11,55,0,55,0,0,0,0
1135,118-GANDHINAGAR,040048-Adarsh Vidhyalay,12,55,55,0,47,8,100,85.45
1136,106-KOCHI,M40059-Islamic Central School,12,55,55,0,20,35,100,36.36
1137,111-ALLAHABAD/PRAYAGRAJ,210668-Identity Educational Academy,13,55,42,13,35,7,76.36,63.64
1138,107-DELHI,210509-New Adarsh Public School,12,54,0,54,0,0,0,0
1139,105-CHANDIGARH,160027-Shining Stars Senior Sec. School,12,54,54,0,54,0,100,100
1140,120-RANCHI,260192-Kerala Samajam Model School,11,54,54,0,37,17,100,68.52
1141,109-JAIPUR,170386-AVS School,13,54,51,3,20,31,94.44,37.04
1142,102-PUNE,110133-The Chanda Devi Saraf School,11,54,54,0,49,5,100,90.74
1143,102-PUNE,110055-Divine Provident High School & Jr. College,12,54,54,0,53,1,100,98.15
1144,107-DELHI,210383-Mahaveer Singh Inter College,13,54,32,22,32,0,59.26,59.26
1145,107-DELHI,270512-Jagriti Public School,13,54,0,54,0,0,0,0
1146,120-RANCHI,260122-J.b.c. +2 School,10,54,0,54,0,0,0,0
1147,114-DEHRADUN,M38344-Madarsa Maulana Abul Kalam Azad,15,54,54,0,54,0,100,100
1148,114-DEHRADUN,340252-Divine Light School,12,54,4,50,0,4,7.41,0
1149,114-DEHRADUN,210317-St. Francis School,10,53,53,0,53,0,100,100
1150,125-JAMMU,070032-Jawahar Navodaya Vidyalaya,11,53,53,0,53,0,100,100
1151,114-DEHRADUN,340203-Government Inter College,13,53,53,0,53,0,100,100
1152,123-GANGTOK,220055-Auxilium Convent,10,53,52,1,52,0,98.11,98.11
1153,107-DELHI,M38365-New Horizon School,11,53,53,0,44,9,100,83.02
1154,114-DEHRADUN,M38216-Islamia Inter Collere,14,53,53,0,53,0,100,100
1155,123-GANGTOK,180011-Govt. Senior Secondary School,12,53,53,0,50,3,100,94.34
1156,120-RANCHI,260052-Rabindra Nath Tagore Inter College,12,53,51,2,51,0,96.23,96.23
1157,111-ALLAHABAD/PRAYAGRAJ,210775-Smart Indian Model School,13,53,22,31,16,6,41.51,30.19
1158,118-GANDHINAGAR,390129-P. Chandra International School,11,53,53,0,38,15,100,71.7
1159,103-KOLKATA,460520-Khanyadihi High School,12,53,53,0,50,3,100,94.34
1160,111-ALLAHABAD/PRAYAGRAJ,210322-Purvanchal Bal Shramik Madhyasmik,12,53,53,0,53,0,100,100
1161,114-DEHRADUN,340285-Gandhi Inter College,14,52,52,0,52,0,100,100
1162,105-CHANDIGARH,050117-Shivalik Senior Secondary School,14,52,52,0,52,0,100,100
1163,120-RANCHI,260095-Govt. Russel +2 High School,12,52,0,52,0,0,0,0
1164,107-DELHI,270177-Gagan Bharti Public School,12,52,47,5,43,4,90.38,82.69
1165,123-GANGTOK,180010-Govt. Senior Secondary School,12,52,19,33,0,19,36.54,0
1166,102-PUNE,110044-Jai Bharat High School& Jr.college,10,52,52,0,49,3,100,94.23
1167,107-DELHI,210761-NARAYANA PUBLIC SCHOOL,11,52,51,1,13,38,98.08,25
1168,109-JAIPUR,170313-Nav Nirman Bal Niketan Sec.school,13,51,51,0,51,0,100,100
1169,121-CHENNAI,190108-Mahatma Montessori School,18,51,46,5,46,0,90.2,90.2
1170,105-CHANDIGARH,050574-INDOLOGY PUBLIC SR. SEC. SCHOOL,11,51,49,2,32,17,96.08,62.75
1171,113-BHOPAL,100008-Kendriya Vidyalaya No.1,13,51,0,51,0,0,0,0
1172,114-DEHRADUN,M38250-Jamia Tut Tayyibat Niswan College,11,51,44,7,4,40,86.27,7.84
1173,107-DELHI,270292-T.N.Public School,12,51,49,2,49,0,96.08,96.08
1174,107-DELHI,050122-M.D. High School,11,51,50,1,50,0,98.04,98.04
1175,109-JAIPUR,M17074-Baba Har Singh Bedi Memorial,11,51,48,3,34,14,94.12,66.67
1176,105-CHANDIGARH,"050259-Vidya Bharti Sr.sec.school,",12,51,51,0,50,1,100,98.04
1177,109-JAIPUR,170303-Sethi Sr.sec.school,13,51,49,2,29,20,96.08,56.86
1178,107-DELHI,270522-Shri Tula Ram Public School,10,51,0,51,0,0,0,0
1179,118-GANDHINAGAR,040076-Shree V M Chandera Secondary and Higher Sec. School,10,51,51,0,41,10,100,80.39
1180,121-CHENNAI,190111-The Trinity Academy,10,50,12,38,9,3,24,18
1181,104-GUWAHATI,029001-Model Study Centre,13,50,49,1,34,15,98,68
1182,106-KOCHI,M40072-Al Ameen English School,11,50,50,0,32,18,100,64
1183,115-BHUBANESWAR,410134-410134-BARRKS HIGH SCHOOL,16,50,48,2,28,20,96,56
1184,104-GUWAHATI,020028-Kendriya Vidyalaya,11,50,49,1,26,23,98,52
1185,114-DEHRADUN,340187-Jawahar Navodaya Vidyalaya,12,50,0,50,0,0,0,0
1186,117-BENGALURU,M08026-Bethany High School,13,50,50,0,46,4,100,92
1187,109-JAIPUR,170383-New Rajasthan Public Sr.Sec.School,10,50,50,0,49,1,100,98
1188,114-DEHRADUN,210175-Dayanand Saraswati Inter College,13,50,1,49,1,0,2,2
1189,106-KOCHI,M40065-Iqra Islamic Women's College,11,50,50,0,50,0,100,100
1190,107-DELHI,210772-Bloom International School,11,50,40,10,4,36,80,8
1191,107-DELHI,270549-D K Convent School,11,50,50,0,37,13,100,74
1192,118-GANDHINAGAR,040005-Queen Of Angels Convent School,10,50,50,0,33,17,100,66
1193,117-BENGALURU,080031-Kendriya Vidyalaya,13,50,50,0,25,25,100,50
1194,118-GANDHINAGAR,040064-Navrachana school,16,50,50,0,36,14,100,72
1195,114-DEHRADUN,340195-Govt. Inter College,13,50,50,0,0,50,100,0
1196,115-BHUBANESWAR,M15042-Syed Saminary High School,9,50,50,0,46,4,100,92
1197,107-DELHI,270432-Delhi Convent School,10,49,48,1,39,9,97.96,79.59
1198,105-CHANDIGARH,160049-Tagore Public School,12,49,48,1,45,3,97.96,91.84
1199,111-ALLAHABAD/PRAYAGRAJ,210132-Zakir Hussain Model Sr.sec.school,11,49,24,25,5,19,48.98,10.2
1200,114-DEHRADUN,M34237-Madarsa Garib Nawaz,10,49,49,0,49,0,100,100
1201,105-CHANDIGARH,160069-K.K.MAHAJAN A.V.M. Sr.Sec SCHOOL,10,49,45,4,40,5,91.84,81.63
1202,111-ALLAHABAD/PRAYAGRAJ,210730-Kendriya Vidyalaya No.2,15,49,42,7,42,0,85.71,85.71
1203,106-KOCHI,400042-Kendriya Vidyalaya,10,49,49,0,23,26,100,46.94
1204,106-KOCHI,090093-Rani Public School,11,48,48,0,48,0,100,100
1205,118-GANDHINAGAR,390113-Nand Vidya Niketan,12,48,48,0,37,11,100,77.08
1206,102-PUNE,"M11086-Lady Khatun Marium School,",9,48,46,2,28,18,95.83,58.33
1207,102-PUNE,110033-Shoeb High School & Jr.college,10,48,48,0,48,0,100,100
1208,109-JAIPUR,170237-Kiran Bal Bharti Sr.sec. School,10,48,37,11,24,13,77.08,50
1209,122-DHARAMSALA,060023-Akal Academy,12,48,3,45,2,1,6.25,4.17
1210,111-ALLAHABAD/PRAYAGRAJ,210313-Lord Mahakaleshwar Inter College,10,48,48,0,48,0,100,100
1211,104-GUWAHATI,120046-The Little Angel's English School,12,48,48,0,24,24,100,50
1212,104-GUWAHATI,300017-Govt. Khawzawl High School,12,48,48,0,36,12,100,75
1213,113-BHOPAL,J10208-District Jail,8,48,48,0,48,0,100,100
1214,117-BENGALURU,M08059-SERA JE SECONDARY SCHOOL,9,48,48,0,48,0,100,100
1215,120-RANCHI,260044-Dav Public School,10,48,48,0,48,0,100,100
1216,104-GUWAHATI,020051-Jawahar Navodaya Vidyalaya,10,48,48,0,24,24,100,50
1217,107-DELHI,210801-Paras Public School,10,47,0,47,0,0,0,0
1218,109-JAIPUR,170134-Sanskar Shikshan Sansthan,10,47,47,0,47,0,100,100
1219,105-CHANDIGARH,050438-S.D. Senior Secondary School,12,47,47,0,31,16,100,65.96
1220,121-CHENNAI,190041-Riverside Public School,15,47,0,47,0,0,0,0
1221,120-RANCHI,260188-Jasidih Public School,11,47,0,47,0,0,0,0
1222,122-DHARAMSALA,060022-St. Luke's High School,11,47,0,47,0,0,0,0
1223,105-CHANDIGARH,050150-Arya Sr. Sec. School,11,47,47,0,0,47,100,0
1224,104-GUWAHATI,200021-Chandraipara H.s.school,10,47,46,1,39,7,97.87,82.98
1225,103-KOLKATA,460526-Durgapur Iswar Chandra Vidyasagar (DICV) Public School,10,47,42,5,21,21,89.36,44.68
1226,104-GUWAHATI,020037-Kendriya Vidyalaya,13,47,47,0,34,13,100,72.34
1227,109-JAIPUR,170291-Shri Ram Public Sr. Sec. School,10,47,47,0,46,1,100,97.87
1228,109-JAIPUR,320612-HRDC HQ 16 INF Div,14,47,43,4,24,19,91.49,51.06
1229,117-BENGALURU,M08058-SILICON CITY PUBLIC SCHOOL,11,47,47,0,43,4,100,91.49
1230,120-RANCHI,M26082-Loyala School,11,47,47,0,47,0,100,100
1231,110-PATNA,030263-+2 Zila School,12,47,34,13,1,33,72.34,2.13
1232,114-DEHRADUN,M21647-Madrasa Jamiatus Salihat Girls,9,47,46,1,46,0,97.87,97.87
1233,107-DELHI,270404-Shanti Gyan International,9,47,0,47,0,0,0,0
1234,105-CHANDIGARH,160170-New Model Sr. Sec. School,12,46,45,1,31,14,97.83,67.39
1235,105-CHANDIGARH,250015-THE BRITISH SCHOOL,10,46,46,0,21,25,100,45.65
1236,121-CHENNAI,190081-Govt. Hr. Sec. School,11,46,42,4,22,20,91.3,47.83
1237,104-GUWAHATI,020008-Carmel Trng. Cen.of Donbosco School,9,46,46,0,45,1,100,97.83
1238,105-CHANDIGARH,"160071-B.c.m.arya Model Sr.sec.school,",12,46,45,1,29,16,97.83,63.04
1239,111-ALLAHABAD/PRAYAGRAJ,210043-Allahabad Gram Vikas Samiti,12,46,29,17,13,16,63.04,28.26
1240,117-BENGALURU,080078-BGS National Public School,11,46,46,0,19,27,100,41.3
1241,105-CHANDIGARH,M38014-Ilyas Public School,11,46,46,0,46,0,100,100
1242,118-GANDHINAGAR,390075-K.r. Doshi High School,10,45,45,0,45,0,100,100
1243,107-DELHI,210035-Kendriya Vidyalaya No.1,12,45,0,45,0,0,0,0
1244,109-JAIPUR,170082-Lal Bahadur Shastri Sr.sec School,8,45,45,0,45,0,100,100
1245,109-JAIPUR,170425-Shaheed Kansingh Memorial Shikshan Sansthan Senior Secondary School,9,45,45,0,45,0,100,100
1246,114-DEHRADUN,340105-Govt. Inter College,9,45,0,45,0,0,0,0
1247,102-PUNE,"M38037-Shoeb High School & Jr College,",9,45,45,0,45,0,100,100
1248,120-RANCHI,260108-S.s. +2 High School,10,45,0,45,0,0,0,0
1249,104-GUWAHATI,020057-Kendriya Vidyalaya,9,45,45,0,22,23,100,48.89
1250,104-GUWAHATI,M38331-Maryam Ajmal Women's College Of,9,45,0,45,0,0,0,0
1251,107-DELHI,270347-Shishu Niketan Public School,9,45,40,5,17,23,88.89,37.78
1252,111-ALLAHABAD/PRAYAGRAJ,210044-Aminabad Inter College,15,45,22,23,8,14,48.89,17.78
1253,121-CHENNAI,M42001-Kh Matriculation Boys Hr.sec.school,10,45,40,5,38,2,88.89,84.44
1254,109-JAIPUR,170417-Adarsh Bal Niketan Sr. Sec. School,9,45,45,0,45,0,100,100
1255,103-KOLKATA,M38140-Belgachia Urdu High School,11,45,0,45,0,0,0,0
1256,111-ALLAHABAD/PRAYAGRAJ,210513-Maya Devi Higher Secondary School,8,44,44,0,44,0,100,100
1257,122-DHARAMSALA,060062-Govt.sr.sec.school,10,44,0,44,0,0,0,0
1258,114-DEHRADUN,340324-Persistent Students Nest Higher Secondary School,10,44,44,0,42,2,100,95.45
1259,113-BHOPAL,100044-Raghuvansh Higher Sec. School,11,44,39,5,0,39,88.64,0
1260,105-CHANDIGARH,M16105-Almighty Public School,11,44,44,0,32,12,100,72.73
1261,107-DELHI,210366-Kendriya Vidyalaya,9,44,0,44,0,0,0,0
1262,121-CHENNAI,190098-Sri Seshaas Public School,15,44,41,3,41,0,93.18,93.18
1263,109-JAIPUR,170137-A.n. Public School,10,44,40,4,39,1,90.91,88.64
1264,111-ALLAHABAD/PRAYAGRAJ,M21196-Amiruddaula Islamia Inter College,11,43,26,17,16,10,60.47,37.21
1265,110-PATNA,030073-Rashtiya Ucch Vidyalaya,10,43,43,0,37,6,100,86.05
1266,113-BHOPAL,M38346-Madarsa Nascent Diniyat,7,43,43,0,43,0,100,100
1267,107-DELHI,270518-Vasundhara Public School,11,43,43,0,43,0,100,100
1268,113-BHOPAL,100302-Siddhi Vinayak Public School,7,43,43,0,43,0,100,100
1269,107-DELHI,210650-Bhagirath Public School,9,43,0,43,0,0,0,0
1270,114-DEHRADUN,340185-Will Field School,12,43,43,0,43,0,100,100
1271,111-ALLAHABAD/PRAYAGRAJ,210783-Jim Corbett Public School,9,43,22,21,9,13,51.16,20.93
1272,121-CHENNAI,190062-Govt. Boys Higher Secondary School,12,43,0,43,0,0,0,0
1273,107-DELHI,270504-Yuvashakti Model School,11,43,40,3,40,0,93.02,93.02
1274,114-DEHRADUN,340200-Govt. Inter College,12,43,0,43,0,0,0,0
1275,109-JAIPUR,170395-Swami Shree Niwas Acharya Shikshan,9,43,43,0,34,9,100,79.07
1276,117-BENGALURU,M08060-Orchids The International School,9,43,43,0,27,16,100,62.79
1277,102-PUNE,110141-Sree Narayana Guru College of Commerce,8,43,40,3,35,5,93.02,81.4
1278,118-GANDHINAGAR,040045-Saraswat International Academy,9,43,43,0,28,15,100,65.12
1279,114-DEHRADUN,340170-Rashtriya Inter College,8,43,0,43,0,0,0,0
1280,110-PATNA,030150-Rajkiyakrit Rajput Ucch Vidyalaya,9,43,25,18,6,19,58.14,13.95
1281,103-KOLKATA,220113-Devaki Memorial School,10,43,43,0,43,0,100,100
1282,125-JAMMU,M07049-Muslim Institute Of Education,9,42,11,31,1,10,26.19,2.38
1283,109-JAIPUR,170240-Govind Vidya Mandir Hr.sec. School,12,42,42,0,42,0,100,100
1284,110-PATNA,J03014-District Jail,8,42,42,0,42,0,100,100
1285,103-KOLKATA,M22099-Asansol St.Anthony Secondary School,7,42,0,42,0,0,0,0
1286,102-PUNE,110148-Indira National School,11,42,42,0,41,1,100,97.62
1287,106-KOCHI,M40035-Darul Hikam Residential School,9,42,42,0,16,26,100,38.1
1288,117-BENGALURU,M38164-Daffodils High School,8,42,42,0,42,0,100,100
1289,111-ALLAHABAD/PRAYAGRAJ,210138-Ajay Girls Inter College,11,42,42,0,11,31,100,26.19
1290,105-CHANDIGARH,050066-Dharamvati Public Sr. Sec. School,10,42,42,0,9,33,100,21.43
1291,118-GANDHINAGAR,390157-Chavda S J And Shah S B High School,7,42,42,0,42,0,100,100
1292,103-KOLKATA,M22095-Abbot Shishu Hall,8,42,0,42,0,0,0,0
1293,120-RANCHI,260125-Rajkiyakrit  +2 High School,10,42,11,31,5,6,26.19,11.9
1294,111-ALLAHABAD/PRAYAGRAJ,210324-Maharishi Arvind Shikshan Sansthan,8,42,40,2,6,34,95.24,14.29
1295,114-DEHRADUN,340271-Govt. Inter College,8,42,0,42,0,0,0,0
1296,113-BHOPAL,M10174-Madarsa Firdos Hr.sec.study Center,7,41,0,41,0,0,0,0
1297,115-BHUBANESWAR,J15159-District Jail,10,41,32,9,23,9,78.05,56.1
1298,111-ALLAHABAD/PRAYAGRAJ,210789-Vikas Bharti School,10,41,16,25,13,3,39.02,31.71
1299,110-PATNA,"030314-Sitamarhi Inter +2 College,",8,41,35,6,1,34,85.37,2.44
1300,106-KOCHI,M40071-Gods Own Public School,8,41,41,0,41,0,100,100
1301,107-DELHI,M27479-Khadijatul Kubra Girls Public Sch.,11,41,41,0,41,0,100,100
1302,105-CHANDIGARH,050356-V.B.N. Senior Secondary School,9,41,41,0,30,11,100,73.17
1303,104-GUWAHATI,"240005-Govt. Hr.sec. School,",9,41,41,0,28,13,100,68.29
1304,121-CHENNAI,M42004-Saudia Oriental Arabic Hr. Sec. School,10,41,41,0,41,0,100,100
1305,110-PATNA,030335-Rajkiya Inter +2 School,8,41,33,8,14,19,80.49,34.15
1306,105-CHANDIGARH,050506-Aryans Model Sr. Sec. School,9,41,41,0,41,0,100,100
1307,105-CHANDIGARH,050094-Gaur Brahman Vidya Parcharini Sabha,9,41,40,1,15,25,97.56,36.59
1308,111-ALLAHABAD/PRAYAGRAJ,210596-M.G. Convent School,12,41,28,13,6,22,68.29,14.63
1309,114-DEHRADUN,340205-Govt. Pratap Inter College,11,40,0,40,0,0,0,0
1310,117-BENGALURU,450058-Spastic Society Of Karnataka,11,40,40,0,40,0,100,100
1311,106-KOCHI,400050-Kendriya Vidyalaya,8,40,40,0,11,29,100,27.5
1312,118-GANDHINAGAR,390158-Rasiklal Nathulal Shah (Rangwala) Secondary & Higher Secondary School,8,40,40,0,36,4,100,90
1313,107-DELHI,270474-Indian Convent School,7,40,40,0,40,0,100,100
1314,105-CHANDIGARH,050585-KVM PUBLIC SCHOOL,8,40,40,0,15,25,100,37.5
1315,109-JAIPUR,170249-Adarsh Ucch Madhyamik Bal Vidyalaya,9,40,37,3,36,1,92.5,90
1316,109-JAIPUR,170389-Floradale Public School,9,40,29,11,8,21,72.5,20
1317,111-ALLAHABAD/PRAYAGRAJ,210189-Sant Ramkrishan Kanya Intercollege,10,39,30,9,14,16,76.92,35.9
1318,120-RANCHI,450032-Manthan Yuva Sangathan,8,39,31,8,31,0,79.49,79.49
1319,114-DEHRADUN,340250-Bhagirathi Vidyalaya,8,39,39,0,39,0,100,100
1320,106-KOCHI,400040-Kendriya Vidyalaya No-2,8,39,39,0,15,24,100,38.46
1321,111-ALLAHABAD/PRAYAGRAJ,210741-Florets International School,8,39,24,15,13,11,61.54,33.33
1322,109-JAIPUR,170230-Sh. Ram Karan Joshi Govt. Hr. Sec.,9,39,39,0,39,0,100,100
1323,104-GUWAHATI,440009-Sree Narasinghasthan High School,8,39,38,1,28,10,97.44,71.79
1324,103-KOLKATA,220120-AGPN Convent & E.R. School,8,39,0,39,0,0,0,0
1325,107-DELHI,210233-National Public Sr.sec.school,9,39,0,39,0,0,0,0
1326,121-CHENNAI,M19042-Montfort Matric Hr.sec. School,18,39,38,1,24,14,97.44,61.54
1327,102-PUNE,110006-St.joseph's Convent Girls H.school,17,39,39,0,34,5,100,87.18
1328,114-DEHRADUN,340128-Govt. Inter College,9,38,0,38,0,0,0,0
1329,102-PUNE,M11078-St. Ursula High School,9,38,38,0,38,0,100,100
1330,107-DELHI,270208-Govt. Sarvodaya Bal Vidyalaya,9,38,0,38,0,0,0,0
1331,105-CHANDIGARH,050588-B.V.N. Sr. Sec. School,8,38,38,0,16,22,100,42.11
1332,121-CHENNAI,190126-R.D. International School,7,38,38,0,35,3,100,92.11
1333,113-BHOPAL,"100075-Vikram Higher Secondary School,",10,38,4,34,0,4,10.53,0
1334,110-PATNA,M03362-Sadar Alam Memorial Sr.sec.school,8,38,38,0,38,0,100,100
1335,108-ABROAD/NIOS HQ,940001-LAURELS EDUCATION SERVICES WILL,8,38,0,38,0,0,0,0
1336,105-CHANDIGARH,160013-D.r.modern Sr. Sec.school,8,38,37,1,11,26,97.37,28.95
1337,115-BHUBANESWAR,150036-150036-Jawahar Navodaya Vidyalaya,9,37,23,14,16,7,62.16,43.24
1338,107-DELHI,270397-Govt. Boys Senior Secondary School,10,37,19,18,16,3,51.35,43.24
1339,104-GUWAHATI,440010-Don Bosco High School,8,37,37,0,31,6,100,83.78
1340,121-CHENNAI,190035-Kendriya Vidyalaya No-2,8,37,1,36,0,1,2.7,0
1341,123-GANGTOK,460531-North Bengal Central School,9,37,37,0,13,24,100,35.14
1342,111-ALLAHABAD/PRAYAGRAJ,210598-T.c. Chandra Inter College,7,37,37,0,37,0,100,100
1343,113-BHOPAL,100183-Maa Sharda Higher Secondary School,7,37,0,37,0,0,0,0
1344,104-GUWAHATI,140022-Kendriya Vidyalaya,8,37,36,1,29,7,97.3,78.38
1345,106-KOCHI,400067-Aliya Senior Secondary School,7,37,37,0,15,22,100,40.54
1346,121-CHENNAI,M38322-Crescent Matric Hr.sec. School,9,37,37,0,37,0,100,100
1347,111-ALLAHABAD/PRAYAGRAJ,450105-Jyoti Badhir Vidyalaya,6,36,36,0,36,0,100,100
1348,111-ALLAHABAD/PRAYAGRAJ,210556-St. Xavier's High School,10,36,36,0,29,7,100,80.56
1349,107-DELHI,050359-Ch. Chain Sukh Sr.sec. School,7,36,0,36,0,0,0,0
1350,113-BHOPAL,J10213-District Jail,9,36,36,0,0,36,100,0
1351,106-KOCHI,400026-Shree Vivekanand Sec.school,9,36,36,0,28,8,100,77.78
1352,103-KOLKATA,220084-Balika Vidya Bhawan,8,36,0,36,0,0,0,0
1353,111-ALLAHABAD/PRAYAGRAJ,M21546-National Public Inter College,8,36,24,12,17,7,66.67,47.22
1354,111-ALLAHABAD/PRAYAGRAJ,210131-St. H.N. Public Inter College,8,36,25,11,16,9,69.44,44.44
1355,105-CHANDIGARH,160115-Anne's School,12,36,35,1,19,16,97.22,52.78
1356,102-PUNE,110124-Gokulnath Sec. & Hr.sec. School,7,36,36,0,35,1,100,97.22
1357,102-PUNE,M11096-St. Felix High School,9,36,36,0,36,0,100,100
1358,121-CHENNAI,190146-APL Global School,17,36,36,0,36,0,100,100
1359,111-ALLAHABAD/PRAYAGRAJ,"210156-Amar Public Inter College,",8,35,23,12,3,20,65.71,8.57
1360,105-CHANDIGARH,050319-Shiv Sr.sec. School,8,35,35,0,24,11,100,68.57
1361,110-PATNA,M03113-Patna Muslim High School Inter Col.,7,35,35,0,10,25,100,28.57
1362,102-PUNE,280013-Kendriya Vidyalaya No.1,7,35,35,0,24,11,100,68.57
1363,107-DELHI,M05365-Ajmat Khan Indian Public School,7,35,35,0,35,0,100,100
1364,107-DELHI,050350-Shanti Niketan Public School,8,35,22,13,21,1,62.86,60
1365,109-JAIPUR,170441-Surya Bal Shiksha Niketan Sr. Sec. School,7,35,33,2,12,21,94.29,34.29
1366,102-PUNE,110049-Shaheed Dunichand T.kalani,8,35,35,0,34,1,100,97.14
1367,114-DEHRADUN,340120-Govt. Inter College,8,35,35,0,35,0,100,100
1368,102-PUNE,110011-Holy Cross Convent High School,8,35,34,1,32,2,97.14,91.43
1369,105-CHANDIGARH,050047-Navyug Public School,7,35,35,0,35,0,100,100
1370,121-CHENNAI,190147-Vedavalli Vidyalaya,7,35,28,7,9,19,80,25.71
1371,107-DELHI,M27489-Jesus Grace Modern School,7,35,0,35,0,0,0,0
1372,110-PATNA,"030348-Town High School,",8,34,23,11,7,16,67.65,20.59
1373,105-CHANDIGARH,050630-Shri Krishna Public School,7,34,34,0,0,34,100,0
1374,104-GUWAHATI,450172-SHISHU SAROTHI CENTRE FOR REHABILITATION AND TRAINING FOR MULTIPLE DISABILITIES,8,34,34,0,29,5,100,85.29
1375,120-RANCHI,260133-+2 Zila School,8,34,0,34,0,0,0,0
1376,111-ALLAHABAD/PRAYAGRAJ,210151-Champa Agarwal Institute Of,8,34,34,0,33,1,100,97.06
1377,105-CHANDIGARH,050074-Maharishi Vidya Mandir,8,34,33,1,13,20,97.06,38.24
1378,107-DELHI,210731-J. D. PUBLIC SCHOOL,7,34,27,7,0,27,79.41,0
1379,105-CHANDIGARH,050556-Guru Nanak Academy,8,34,34,0,34,0,100,100
1380,118-GANDHINAGAR,040103-L D R International School,9,34,33,1,21,12,97.06,61.76
1381,123-GANGTOK,"M22087-Good Shepherd School,",6,34,34,0,34,0,100,100
1382,109-JAIPUR,M17054-Sant Hafiz Public Sec. School,7,34,34,0,30,4,100,88.24
1383,121-CHENNAI,190152-Sri Sankara Vidyalaya Mat. Hr. Sec. School,11,34,34,0,13,21,100,38.24
1384,118-GANDHINAGAR,390156-Shri Vidhyatirth Madhyamik and Ucchatar Madhyamik Shala,6,34,34,0,26,8,100,76.47
1385,102-PUNE,M36148-Anglo Urdu Boys High School & Jr,8,34,34,0,29,5,100,85.29
1386,113-BHOPAL,100239-Alpa Bhashi Higher Secondary School,7,34,0,34,0,0,0,0
1387,118-GANDHINAGAR,040074-Smt. Sandraben Shroff Gnyan Dham School,7,33,33,0,22,11,100,66.67
1388,105-CHANDIGARH,450094-National School For The Handi.sch.,9,33,33,0,25,8,100,75.76
1389,107-DELHI,270201-Delhi Jain Public Sr.sec. School,8,33,0,33,0,0,0,0
1390,109-JAIPUR,170135-Shiv Public Sr.sec. School,8,33,30,3,14,16,90.91,42.42
1391,117-BENGALURU,080023-Swami Vivekananda Vidyashala,7,33,31,2,23,8,93.94,69.7
1392,103-KOLKATA,220123-SAINT CHRISTOPHER'S MISSION SCHOOL,6,33,0,33,0,0,0,0
1393,114-DEHRADUN,M34251-Ranikhet (mission) Inter  College,8,33,0,33,0,0,0,0
1394,103-KOLKATA,460527-Budge Budge St. Paul's Day School,7,33,0,33,0,0,0,0
1395,103-KOLKATA,220121-Army Public School,8,33,0,33,0,0,0,0
1396,125-JAMMU,"070023-Arya Kanya Vidyalaya High School,",7,33,9,24,2,7,27.27,6.06
1397,107-DELHI,270442-Dhruva Public School,8,33,29,4,29,0,87.88,87.88
1398,105-CHANDIGARH,050553-B R International Public School,8,33,33,0,21,12,100,63.64
1399,109-JAIPUR,170378-Pragati Public Sr. Sec. School,6,33,33,0,31,2,100,93.94
1400,114-DEHRADUN,340287-Bright Inter College,8,33,0,33,0,0,0,0
1401,102-PUNE,M11134-St. Mary's High School,7,32,32,0,31,1,100,96.88
1402,105-CHANDIGARH,050518-Aryavart High School,9,32,32,0,32,0,100,100
1403,108-ABROAD/NIOS HQ,"320511-HQ 10 Arty Bde,",8,32,0,32,0,0,0,0
1404,125-JAMMU,M07048-Greenway Public School,7,32,19,13,0,19,59.38,0
1405,117-BENGALURU,T08001-National Skill Training Institute (NSTI),16,32,32,0,12,20,100,37.5
1406,102-PUNE,M11133-MAROTRAO BANSOD JUNIOR COLLEGE,5,32,32,0,29,3,100,90.63
1407,114-DEHRADUN,M21115-H.b.h.high School,10,32,31,1,28,3,96.88,87.5
1408,114-DEHRADUN,M21064-Guru Tegh Bahadur Public School,7,32,28,4,0,28,87.5,0
1409,110-PATNA,030085-Mahavir Inter College,6,32,17,15,0,17,53.13,0
1410,118-GANDHINAGAR,M04037-St. Xavier's Vidya Vihar,7,32,32,0,28,4,100,87.5
1411,114-DEHRADUN,340295-S.N. Memorial Public School,7,32,32,0,32,0,100,100
1412,114-DEHRADUN,M21424-Madarsa Islamia Talimul Quran,7,32,31,1,28,3,96.88,87.5
1413,107-DELHI,"270393-Blooming Dales Public School,",7,32,0,32,0,0,0,0
1414,105-CHANDIGARH,050552-G. R. S. Sr. Sec. School,6,32,32,0,16,16,100,50
1415,114-DEHRADUN,210750-S.D.P.D PUBLIC SCHOOL,6,32,0,32,0,0,0,0
1416,109-JAIPUR,170218-B.r. Khokhar Memorial Sr.sec.school,6,31,28,3,9,19,90.32,29.03
1417,121-CHENNAI,190122-B V M Global School,9,31,28,3,23,5,90.32,74.19
1418,117-BENGALURU,080024-Deccan International School,8,31,31,0,30,1,100,96.77
1419,115-BHUBANESWAR,150201-Times Scholars Gurukul,6,31,22,9,16,6,70.97,51.61
1420,107-DELHI,M27152-St. Xavier School,7,31,0,31,0,0,0,0
1421,109-JAIPUR,170174-Govt. Hr. Sec. School,6,31,28,3,14,14,90.32,45.16
1422,113-BHOPAL,100134-Jawahar Navodaya Vidyalaya,8,31,0,31,0,0,0,0
1423,120-RANCHI,260031-Bokaro Public School,6,31,29,2,29,0,93.55,93.55
1424,106-KOCHI,400052-Kendriya Vidyalaya,6,31,31,0,8,23,100,25.81
1425,103-KOLKATA,220132-Rishi Aurobindo Memorial Academy,6,31,0,31,0,0,0,0
1426,103-KOLKATA,220031-Kendriya Vidyalaya No.1,7,31,0,31,0,0,0,0
1427,117-BENGALURU,080066-Sri Sri Ravishankar Vidya Mandir,8,31,31,0,28,3,100,90.32
1428,115-BHUBANESWAR,150012-Harobino Vidya Bhawan,6,31,27,4,17,10,87.1,54.84
1429,103-KOLKATA,460525-AGPN Convent & E.R. School,6,31,0,31,0,0,0,0
1430,103-KOLKATA,220105-Chakdaha Model School,6,31,0,31,0,0,0,0
1431,120-RANCHI,260197-Sarala Birla Public School,7,31,31,0,20,11,100,64.52
1432,118-GANDHINAGAR,M39063-St.mary's School,9,31,31,0,30,1,100,96.77
1433,114-DEHRADUN,210048-Rab Intermediate College,7,31,1,30,1,0,3.23,3.23
1434,113-BHOPAL,M10095-Adivasi & Viklang Hr.sec.school,7,30,30,0,30,0,100,100
1435,109-JAIPUR,170089-Sumitra Memorial Public School,6,30,30,0,10,20,100,33.33
1436,105-CHANDIGARH,050224-Harsh Public Sr.sec.school,6,30,30,0,30,0,100,100
1437,104-GUWAHATI,M13018-Ferrando Speech and Hearing Centre,6,30,30,0,30,0,100,100
1438,121-CHENNAI,"190028-Kendriya Vidyalaya,",7,30,30,0,26,4,100,86.67
1439,111-ALLAHABAD/PRAYAGRAJ,210419-Career Convent Girls College,6,30,11,19,0,11,36.67,0
1440,118-GANDHINAGAR,390123-Jay Ambe International School,7,30,30,0,23,7,100,76.67
1441,105-CHANDIGARH,050591-Ideal International School,7,30,30,0,30,0,100,100
1442,110-PATNA,030091-Jayanand Ucch Vidyalaya,6,30,30,0,30,0,100,100
1443,109-JAIPUR,170131-Badhal Sunrise Senior Secondary,7,30,30,0,30,0,100,100
1444,103-KOLKATA,220058-Paranami Balika Vidya Mandir,5,30,0,30,0,0,0,0
1445,107-DELHI,270094-Siddharth International Pub.School,8,30,0,30,0,0,0,0
1446,101-HYDERABAD,470005-St. Philomena High School,8,30,29,1,29,0,96.67,96.67
1447,114-DEHRADUN,340006-Children's Sr. Academy,6,30,0,30,0,0,0,0
1448,110-PATNA,"030338-Madwari Inter +2 College,",7,30,25,5,6,19,83.33,20
1449,121-CHENNAI,190034-Kendriya Vidyalaya No-1,10,30,0,30,0,0,0,0
1450,109-JAIPUR,"170100-Kendriya Vidyalaya No. 2,",8,30,14,16,5,9,46.67,16.67
1451,107-DELHI,270247-Universal Public School,8,30,0,30,0,0,0,0
1452,105-CHANDIGARH,050526-Green Fields Public School,6,29,28,1,5,23,96.55,17.24
1453,121-CHENNAI,190030-Kendriya Vidyalaya,8,29,29,0,27,2,100,93.1
1454,110-PATNA,030326-Rajkiya +2 High School,7,29,23,6,4,19,79.31,13.79
1455,121-CHENNAI,420063-Kendriya Vidyalaya,6,29,24,5,4,20,82.76,13.79
1456,105-CHANDIGARH,050516-Galaxy International School,6,29,29,0,20,9,100,68.97
1457,104-GUWAHATI,M02067-AUXILIUM CONVENT HIGH SCHOOL,7,29,29,0,29,0,100,100
1458,109-JAIPUR,170310-Vidyagram International School,5,29,20,9,8,12,68.97,27.59
1459,104-GUWAHATI,"020043-Kendriya Vidyalaya ONGC,",8,29,29,0,22,7,100,75.86
1460,121-CHENNAI,190065-P.k. Govt. Girls Hr.sec. School,6,29,29,0,16,13,100,55.17
1461,110-PATNA,M38224-Khalikum  Nisha Sajjad Millat,6,29,4,25,1,3,13.79,3.45
1462,110-PATNA,"030257-+2 Zila School,",6,29,19,10,2,17,65.52,6.9
1463,114-DEHRADUN,340262-V.m.j.s. Govt. Inter College,7,29,0,29,0,0,0,0
1464,121-CHENNAI,190129-Manchester International School,6,29,3,26,0,3,10.34,0
1465,110-PATNA,030079-Gandhi Inter Vidyalay,7,29,27,2,3,24,93.1,10.34
1466,106-KOCHI,400022-Trinity Lyceum,6,29,29,0,26,3,100,89.66
1467,104-GUWAHATI,130030-Army Public School,6,29,29,0,29,0,100,100
1468,121-CHENNAI,190164-Good Word Public School,8,29,29,0,29,0,100,100
1469,120-RANCHI,260138-+2 R.k. High School,6,29,26,3,14,12,89.66,48.28
1470,107-DELHI,210575-Braham Rishi Krishan Dutt Inter,7,29,0,29,0,0,0,0
1471,114-DEHRADUN,M21653-Pragati Senior Secondary School,6,29,0,29,0,0,0,0
1472,105-CHANDIGARH,050326-City Sr.sec.school,6,29,29,0,17,12,100,58.62
1473,113-BHOPAL,M10203-Madarsa Hazrat Bilal,6,29,29,0,3,26,100,10.34
1474,125-JAMMU,070009-Govt. Higher Secondary School,6,29,5,24,0,5,17.24,0
1475,107-DELHI,270561-Holy World School,7,29,29,0,29,0,100,100
1476,125-JAMMU,070056-Army Public School,6,28,26,2,2,24,92.86,7.14
1477,109-JAIPUR,170402-Shanti Niketan Sr. Sec. School,6,28,27,1,27,0,96.43,96.43
1478,105-CHANDIGARH,160054-A.v.m Senior Secondary School,6,28,28,0,11,17,100,39.29
1479,108-ABROAD/NIOS HQ,320103-HQ 33 CORPS HRDC,7,28,0,28,0,0,0,0
1480,105-CHANDIGARH,050158-M.d.n.sr.sec.school,7,28,28,0,21,7,100,75
1481,103-KOLKATA,230009-Govt. Model Sr.Sec. School,7,28,19,9,0,19,67.86,0
1482,109-JAIPUR,170020-Kendriya Vidyalaya No.1,6,28,28,0,28,0,100,100
1483,115-BHUBANESWAR,T15012-CENTURION PRIVATE ITI,14,28,28,0,28,0,100,100
1484,104-GUWAHATI,440006-Kampur Adarsha High School,6,28,28,0,21,7,100,75
1485,114-DEHRADUN,340259-Shantivallabh Memorial Inter Colleg,9,28,0,28,0,0,0,0
1486,111-ALLAHABAD/PRAYAGRAJ,210338-Bal Mitra School,6,28,16,12,1,15,57.14,3.57
1487,105-CHANDIGARH,050096-Shri Ram Sr. Sec. School,6,28,28,0,6,22,100,21.43
1488,115-BHUBANESWAR,150183-Barrk's High School,5,28,20,8,14,6,71.43,50
1489,105-CHANDIGARH,160162-Shakargarh DAV Sr. Sec. School,8,28,27,1,27,0,96.43,96.43
1490,114-DEHRADUN,340214-Kendriya  Vidyalaya,6,28,0,28,0,0,0,0
1491,115-BHUBANESWAR,M41083-Syed Seminary High School,6,28,27,1,24,3,96.43,85.71
1492,111-ALLAHABAD/PRAYAGRAJ,210273-Aliganj Montessori School,12,28,25,3,24,1,89.29,85.71
1493,114-DEHRADUN,340288-P.S. Model Hr. Secondary School,6,28,28,0,28,0,100,100
1494,111-ALLAHABAD/PRAYAGRAJ,210759-MUKULARANYAM ENGLISH SCHOOL,9,28,24,4,22,2,85.71,78.57
1495,107-DELHI,270385-NEW OXFORD PUBLIC SCHOOL,6,28,0,28,0,0,0,0
1496,109-JAIPUR,170412-N.V.N Sr. Sec School,5,27,22,5,5,17,81.48,18.52
1497,114-DEHRADUN,340268-GOVT. INTER COLLEGE,7,27,0,27,0,0,0,0
1498,118-GANDHINAGAR,040082-S.V Public School,5,27,27,0,25,2,100,92.59
1499,105-CHANDIGARH,050639-Hare Krishna International Sr. Sec. School,6,27,27,0,11,16,100,40.74
1500,102-PUNE,M11067-St.paul's English School&jr.college,5,27,27,0,27,0,100,100
1501,107-DELHI,M38357-Victoria Public Senior Secondary School,9,27,11,16,5,6,40.74,18.52
1502,118-GANDHINAGAR,040079-P R Mukhi Sec. & Hr. Sec. School,6,27,27,0,20,7,100,74.07
1503,107-DELHI,270168-Govt. Boys Sr. Sec. School,6,27,0,27,0,0,0,0
1504,117-BENGALURU,080063-SRS Pre-University College,5,27,27,0,12,15,100,44.44
1505,118-GANDHINAGAR,040077-Genius English Medium School,8,27,27,0,20,7,100,74.07
1506,107-DELHI,270487-Army Public School,7,27,0,27,0,0,0,0
1507,104-GUWAHATI,020034-Kendriya Vidyalaya,7,27,26,1,20,6,96.3,74.07
1508,118-GANDHINAGAR,040033-Bright High School,7,27,27,0,12,15,100,44.44
1509,103-KOLKATA,220041-Vidyasagar Higher Secondary School,5,27,27,0,27,0,100,100
1510,105-CHANDIGARH,050166-Holy Angel High School,7,26,26,0,26,0,100,100
1511,111-ALLAHABAD/PRAYAGRAJ,M21001-Faiz-e-aam Modern Education Centre,5,26,17,9,8,9,65.38,30.77
1512,105-CHANDIGARH,160105-Saraswati Vidya Mandir Senior,5,26,26,0,17,9,100,65.38
1513,107-DELHI,450148-TAMANA SPECIAL SCHOOL,7,26,26,0,26,0,100,100
1514,115-BHUBANESWAR,150175-C.s.b. Zilla School,6,26,23,3,13,10,88.46,50
1515,105-CHANDIGARH,160142-S.D. Public School,6,26,26,0,17,9,100,65.38
1516,115-BHUBANESWAR,150015-S.aurobindo Integral Edu.& Res.cen.,5,26,26,0,23,3,100,88.46
1517,121-CHENNAI,190026-Swami Sivananda Vidya Samiti,9,26,26,0,23,3,100,88.46
1518,107-DELHI,270478-Jr Public School,5,26,26,0,26,0,100,100
1519,117-BENGALURU,450024-Asha Kiran Special Needs School,6,26,26,0,26,0,100,100
1520,107-DELHI,270514-RD INTERNATIONAL SCHOOL,6,26,0,26,0,0,0,0
1521,107-DELHI,270375-Bal Vidya Mandir Model School,6,26,26,0,26,0,100,100
1522,120-RANCHI,260199-Kids Garden Secondary School,6,26,26,0,26,0,100,100
1523,120-RANCHI,260087-Jawahar Navodaya Vidyalaya,5,26,0,26,0,0,0,0
1524,111-ALLAHABAD/PRAYAGRAJ,"210282-Shishu Vidya Peeth Inter College,",5,26,16,10,7,9,61.54,26.92
1525,122-DHARAMSALA,060015-Govt.(b) Sr. Sec. School,6,26,21,5,1,20,80.77,3.85
1526,116-VISAKHAPATNAM,010167-Kendriya Vidyalaya,7,26,23,3,23,0,88.46,88.46
1527,114-DEHRADUN,M21389-Ale Mansoob Inter College,6,26,0,26,0,0,0,0
1528,105-CHANDIGARH,050586-SKYPATH GLOBAL SCHOOL,6,26,26,0,2,24,100,7.69
1529,122-DHARAMSALA,060099-Rudra International School,5,26,0,26,0,0,0,0
1530,110-PATNA,"030334-+2 Li Academy,",6,26,17,9,4,13,65.38,15.38
1531,123-GANGTOK,220118-Little Flower School,7,26,26,0,26,0,100,100
1532,109-JAIPUR,170097-Kendriya Vidyalaya No-6,6,26,21,5,5,16,80.77,19.23
1533,103-KOLKATA,460518-Rajasthan Vidyapith,6,26,0,26,0,0,0,0
1534,102-PUNE,360133-Ali Yavar Jung National Institute,5,26,26,0,26,0,100,100
1535,111-ALLAHABAD/PRAYAGRAJ,M21492-Madarsa S. Islamia,6,26,26,0,26,0,100,100
1536,121-CHENNAI,190160-Hindustan International School,6,25,24,1,4,20,96,16
1537,113-BHOPAL,M38263-Deniyat Fadeha Madarsa,5,25,25,0,25,0,100,100
1538,114-DEHRADUN,340315-S.B.N Academy,6,25,0,25,0,0,0,0
1539,118-GANDHINAGAR,390161-Shri V D Mayavanshi High School,5,25,25,0,18,7,100,72
1540,105-CHANDIGARH,J16006-Modern Central Jail,4,25,25,0,12,13,100,48
1541,114-DEHRADUN,340164-Anandale Public School,5,25,0,25,0,0,0,0
1542,104-GUWAHATI,140033-CHARITY RESIDENTIAL SCHOOL,5,25,25,0,10,15,100,40
1543,107-DELHI,050538-BALAJI PUBLIC SCHOOL,6,25,0,25,0,0,0,0
1544,118-GANDHINAGAR,040070-The New Tulip International Schools,5,25,20,5,14,6,80,56
1545,118-GANDHINAGAR,390052-St. Xavier's High School,5,25,25,0,25,0,100,100
1546,113-BHOPAL,J10005-District Jail,5,25,25,0,0,25,100,0
1547,111-ALLAHABAD/PRAYAGRAJ,210684-R.a. Inter College,5,25,16,9,8,8,64,32
1548,122-DHARAMSALA,060035-Govt. Senior Secondary School,5,25,25,0,23,2,100,92
1549,107-DELHI,270471-Chhotu Ram Public School,7,25,0,25,0,0,0,0
1550,110-PATNA,030178-Kendriya Vidyalaya,6,25,25,0,24,1,100,96
1551,111-ALLAHABAD/PRAYAGRAJ,210157-Aditya Birla Intermediate College Renukoot,6,25,25,0,6,19,100,24
1552,110-PATNA,030057-Jawahar Navodaya Vidyalaya,5,25,17,8,0,17,68,0
1553,117-BENGALURU,080060-Air Force School,6,25,25,0,19,6,100,76
1554,107-DELHI,450167-Institute Of Rehabilitation,6,25,25,0,25,0,100,100
1555,105-CHANDIGARH,160155-Mount Litera Zee School,5,25,25,0,25,0,100,100
1556,106-KOCHI,090052-Kendriya Vidyaloaya No-1,7,24,24,0,21,3,100,87.5
1557,121-CHENNAI,420064-Kendriya Vidyalaya No-1,10,24,0,24,0,0,0,0
1558,107-DELHI,M21200-Amity International School,6,24,8,16,0,8,33.33,0
1559,109-JAIPUR,170387-Taigor Shikshan Sansthan Sr.Sec.Sch,5,24,14,10,4,10,58.33,16.67
1560,114-DEHRADUN,340165-Adarsh Shishu Niketan Uchachattar,6,24,0,24,0,0,0,0
1561,105-CHANDIGARH,160125-Krishna College of Hr. Education,5,24,24,0,24,0,100,100
1562,105-CHANDIGARH,050391-Om Shanti Shiksha Sadan Sr.sec.sch.,4,24,24,0,17,7,100,70.83
1563,102-PUNE,110025-Pal Rajendra English High School,5,24,24,0,22,2,100,91.67
1564,107-DELHI,M21658-Madrasa Maulana Abdul Kalam Azad,4,24,24,0,24,0,100,100
1565,114-DEHRADUN,340104-Govt.inter College,6,24,17,7,15,2,70.83,62.5
1566,105-CHANDIGARH,050657-Adarsh Convent Sr. Sec. School,5,24,23,1,15,8,95.83,62.5
1567,107-DELHI,210612-Bal Jyoti Public School,5,24,0,24,0,0,0,0
1568,107-DELHI,050505-New Era Sr.sec. School,5,24,13,11,2,11,54.17,8.33
1569,105-CHANDIGARH,160037-Sacred Heart High School,4,24,22,2,9,13,91.67,37.5
1570,104-GUWAHATI,020067-Noonmati Public School,5,24,23,1,11,12,95.83,45.83
1571,105-CHANDIGARH,250008-Shishu Niketan Model Sr. Sec.school,7,24,23,1,9,14,95.83,37.5
1572,105-CHANDIGARH,050668-Sada Sukh Memorial Public School,6,24,24,0,12,12,100,50
1573,113-BHOPAL,100313-Shri Ravendra Singh Saraswati Hr. Sec. School,5,24,24,0,10,14,100,41.67
1574,114-DEHRADUN,210225-Red Rose High School,5,24,24,0,24,0,100,100
1575,111-ALLAHABAD/PRAYAGRAJ,210187-Dolly's Public Inter College,5,23,17,6,8,9,73.91,34.78
1576,109-JAIPUR,170217-R.k. Public Senior Secondary School,5,23,23,0,23,0,100,100
1577,121-CHENNAI,190067-Govt. Higher Secondary School,5,23,0,23,0,0,0,0
1578,111-ALLAHABAD/PRAYAGRAJ,210653-Samrat Ashok Inter College,4,23,23,0,23,0,100,100
1579,107-DELHI,M05439-Sun Rise Public School,5,23,23,0,12,11,100,52.17
1580,121-CHENNAI,190001-Sri.vidya Mandirsec.sch.&jr.college,5,23,4,19,0,4,17.39,0
1581,105-CHANDIGARH,050363-Sir Chhotu Ram Modern Sr.sec.school,4,23,23,0,23,0,100,100
1582,109-JAIPUR,170208-Govt. Sr.sec. School,7,23,17,6,10,7,73.91,43.48
1583,125-JAMMU,070050-New Naveen Model Hr.sec. School,5,23,0,23,0,0,0,0
1584,105-CHANDIGARH,160024-Shivalik Hills Sr. Sec. Public School,4,23,23,0,17,6,100,73.91
1585,111-ALLAHABAD/PRAYAGRAJ,210644-Study Hall,6,23,23,0,19,4,100,82.61
1586,109-JAIPUR,170384-Gyan Jyoti Model School,4,23,15,8,10,5,65.22,43.48
1587,121-CHENNAI,190117-The Camford International School,6,23,0,23,0,0,0,0
1588,107-DELHI,210776-Bhartiyam School,5,23,0,23,0,0,0,0
1589,111-ALLAHABAD/PRAYAGRAJ,210170-Savitri Devi Shanker Lal Sharma,5,23,21,2,5,16,91.3,21.74
1590,105-CHANDIGARH,050428-Sarvodaya Senior Secondary School,5,23,23,0,23,0,100,100
1591,114-DEHRADUN,"340159-Apollo International School,",6,23,1,22,1,0,4.35,4.35
1592,114-DEHRADUN,340216-Govt. Inter College,6,23,0,23,0,0,0,0
1593,114-DEHRADUN,M21409-Madarsa Babul Ilm,6,23,0,23,0,0,0,0
1594,117-BENGALURU,080032-Jawahar Navodaya Vidyalaya,4,23,23,0,14,9,100,60.87
1595,115-BHUBANESWAR,150184-A.j.o. High School,5,23,23,0,21,2,100,91.3
1596,105-CHANDIGARH,050055-Adarsh High School,5,23,23,0,23,0,100,100
1597,114-DEHRADUN,340309-Rajputana College,4,23,0,23,0,0,0,0
1598,111-ALLAHABAD/PRAYAGRAJ,210165-Sh. Mohanlal Adarsh Inter College,5,23,23,0,6,17,100,26.09
1599,104-GUWAHATI,020068-Icon Academy Jr. College,8,23,22,1,14,8,95.65,60.87
1600,118-GANDHINAGAR,390093-Navrachana School,6,23,23,0,22,1,100,95.65
1601,107-DELHI,M38077-Society For Promotion Of Education,6,23,0,23,0,0,0,0
1602,121-CHENNAI,420084-Veera Savarkar Netaji Matric.school,5,23,23,0,23,0,100,100
1603,109-JAIPUR,170096-Kendriya Vidyalaya,5,23,17,6,7,10,73.91,30.43
1604,115-BHUBANESWAR,150177-Brajamohan High School,5,23,23,0,13,10,100,56.52
1605,117-BENGALURU,480003-Delhi Public School,8,22,21,1,21,0,95.45,95.45
1606,121-CHENNAI,M19107-Kh Matriculation Boys Hr.sec.school,5,22,22,0,22,0,100,100
1607,114-DEHRADUN,340109-Govt. Intermediate College,6,22,0,22,0,0,0,0
1608,117-BENGALURU,080044-Kendriya Vidyalaya No. 2,5,22,22,0,22,0,100,100
1609,121-CHENNAI,190118-Pushpalata Vidya Mandir,5,22,20,2,14,6,90.91,63.64
1610,105-CHANDIGARH,160047-M. G. M. Sr. School,6,22,22,0,6,16,100,27.27
1611,107-DELHI,050605-Jhankar High School,5,22,0,22,0,0,0,0
1612,109-JAIPUR,170307-Bharti Vidhya Niketan Sr.sec.school,5,22,22,0,22,0,100,100
1613,110-PATNA,030371-Jawahar Navodaya Vidyalaya,5,22,20,2,17,3,90.91,77.27
1614,111-ALLAHABAD/PRAYAGRAJ,210809-Green Light Public School,5,22,10,12,5,5,45.45,22.73
1615,107-DELHI,270441-Glorious Public School,6,22,2,20,0,2,9.09,0
1616,106-KOCHI,M09098-Gods Own Public School,5,22,22,0,22,0,100,100
1617,125-JAMMU,070058-Army Public School,6,22,22,0,19,3,100,86.36
1618,125-JAMMU,070057-Army Public School,6,22,18,4,18,0,81.82,81.82
1619,118-GANDHINAGAR,390128-L D R International School,5,22,22,0,17,5,100,77.27
1620,121-CHENNAI,190009-Kendriya Vidyalaya,5,22,16,6,13,3,72.73,59.09
1621,102-PUNE,M11087-St.john's School,6,21,21,0,21,0,100,100
1622,109-JAIPUR,170372-J.D. International School,5,21,21,0,18,3,100,85.71
1623,104-GUWAHATI,020029-Kendriya Vidyalaya,4,21,20,1,18,2,95.24,85.71
1624,119-RAIPUR,290050-Jatan Devi Daga Hr.sec.school,6,21,0,21,0,0,0,0
1625,107-DELHI,210787-Delhi Public School,4,21,0,21,0,0,0,0
1626,102-PUNE,110135-Kendriya Vidyalaya,4,21,21,0,17,4,100,80.95
1627,105-CHANDIGARH,050620-G.L Public School,4,21,21,0,21,0,100,100
1628,105-CHANDIGARH,050214-Golden Sr. Sec. School,5,21,20,1,0,20,95.24,0
1629,107-DELHI,270413-Jeevan Public School,5,21,0,21,0,0,0,0
1630,114-DEHRADUN,M38368-F.D Islamia Inter College,5,21,0,21,0,0,0,0
1631,123-GANGTOK,180012-Govt. Senior Secondary School,5,21,0,21,0,0,0,0
1632,109-JAIPUR,170021-Kendriya Vidyalaya,5,21,20,1,9,11,95.24,42.86
1633,119-RAIPUR,290038-Uday Higher Secondary School,4,21,0,21,0,0,0,0
1634,114-DEHRADUN,210242-Gyan Bharti Inter College,4,21,0,21,0,0,0,0
1635,121-CHENNAI,190115-Kmc Public Senior Secondary School,6,21,21,0,20,1,100,95.24
1636,110-PATNA,030081-Anugrah Ucch Vidyalaya,4,21,18,3,12,6,85.71,57.14
1637,105-CHANDIGARH,050568-MAM CHAND PUBLIC SCHOOL ,4,21,21,0,20,1,100,95.24
1638,106-KOCHI,M40060-Mcf Public School,4,21,21,0,21,0,100,100
1639,115-BHUBANESWAR,150191-Chitalo Mohavidyalaya,4,21,13,8,9,4,61.9,42.86
1640,105-CHANDIGARH,160088-Deshmesh Public School,5,21,21,0,6,15,100,28.57
1641,107-DELHI,050293-B.r.m.sr.sec. School,5,21,5,16,5,0,23.81,23.81
1642,107-DELHI,050592-D V M High School,4,21,21,0,21,0,100,100
1643,121-CHENNAI,190032-Kendriya Vidyalaya,5,21,20,1,6,14,95.24,28.57
1644,109-JAIPUR,170344-M.r. Adarsh Academy Sec. School,5,21,20,1,11,9,95.24,52.38
1645,104-GUWAHATI,200014-Santirbazar H.s.school,4,21,21,0,15,6,100,71.43
1646,104-GUWAHATI,120005-D' Regina Higher Secondary School,5,21,20,1,13,7,95.24,61.9
1647,107-DELHI,210676-New Sainik Public School,5,21,0,21,0,0,0,0
1648,107-DELHI,050390-Saarthi Public Sr.sec. School,4,21,0,21,0,0,0,0
1649,117-BENGALURU,080059-East West Public School,4,20,20,0,17,3,100,85
1650,105-CHANDIGARH,050123-Deep Arya High School,4,20,20,0,0,20,100,0
1651,105-CHANDIGARH,M16113-SHRI GURU HARKRISHAN PUBLIC SCHOOL,4,20,19,1,12,7,95,60
1652,110-PATNA,"030259-Govt.high School,",4,20,17,3,3,14,85,15
1653,104-GUWAHATI,020061-R J Senior Secondary School,4,20,18,2,18,0,90,90
1654,104-GUWAHATI,020059-Orang Higher Secondary School,4,20,20,0,8,12,100,40
1655,109-JAIPUR,170334-Kendriya Vidya Mandir Sr.sec.school,5,20,17,3,3,14,85,15
1656,114-DEHRADUN,210484-Subhash Smarak Inter College,4,20,0,20,0,0,0,0
1657,111-ALLAHABAD/PRAYAGRAJ,210450-Vinayak Academy Inter College,4,20,9,11,3,6,45,15
1658,101-HYDERABAD,470214-Geethanjali Junior College,4,20,20,0,20,0,100,100
1659,107-DELHI,210599-J.p.s. Global Academy,4,20,0,20,0,0,0,0
1660,121-CHENNAI,190150-Primrose Schools,6,20,18,2,3,15,90,15
1661,103-KOLKATA,220079-Godwin Modern School,4,20,20,0,16,4,100,80
1662,105-CHANDIGARH,050147-Bal Bharti Sr.sec.school,4,20,20,0,13,7,100,65
1663,104-GUWAHATI,140003-Jawahar Navodaya Vidyalaya,4,20,20,0,12,8,100,60
1664,121-CHENNAI,M42002-Crescent Matric Hr.sec. School,4,20,20,0,20,0,100,100
1665,115-BHUBANESWAR,410147-Centurion University of Technology and Management,3,20,20,0,20,0,100,100
1666,121-CHENNAI,190165-SRM Public School,4,20,20,0,7,13,100,35
1667,102-PUNE,110048-Bharti Sanskrit Vidya Niketaram,6,20,20,0,20,0,100,100
1668,110-PATNA,030267-Kamala Nehru Shishu Vihar,4,20,20,0,1,19,100,5
1669,105-CHANDIGARH,M16103-Guru Nanak Dev Model Sr.sec.school,4,20,13,7,6,7,65,30
1670,107-DELHI,270159-Govt. Sarvodaya Bal Vidyalaya No.-1,5,20,0,20,0,0,0,0
1671,109-JAIPUR,T17008-Sushila Devi Pvt. ITI,10,20,20,0,15,5,100,75
1672,105-CHANDIGARH,450179-Tapan Rehabilitition Society,4,20,20,0,2,18,100,10
1673,104-GUWAHATI,"M02016-Don Bosco School, Sundempuri,",5,19,19,0,19,0,100,100
1674,103-KOLKATA,380303-Kankinara Himayatul Ghurba,4,19,9,10,9,0,47.37,47.37
1675,104-GUWAHATI,020014-Maria Public Educational Trust,4,19,19,0,18,1,100,94.74
1676,120-RANCHI,260118-+2 S.s.d. High School,4,19,19,0,18,1,100,94.74
1677,117-BENGALURU,080055-National Centre For Excellence,6,19,19,0,13,6,100,68.42
1678,110-PATNA,030248-V.m.high School,4,19,16,3,2,14,84.21,10.53
1679,113-BHOPAL,100307-Army Public School No.1,6,19,0,19,0,0,0,0
1680,119-RAIPUR,290065-Jawahar Navodaya Vidyalaya,4,19,0,19,0,0,0,0
1681,105-CHANDIGARH,050401-Golden Public School,4,19,19,0,9,10,100,47.37
1682,102-PUNE,360042-Jath High School,4,19,19,0,16,3,100,84.21
1683,109-JAIPUR,170427-Doon Children Academy Sr. Sec. School,4,19,19,0,11,8,100,57.89
1684,114-DEHRADUN,340281-P.d.s.s. Inter College,4,19,14,5,14,0,73.68,73.68
1685,113-BHOPAL,100301-Govt. Koushal Vikash Kendra Academy,4,19,14,5,0,14,73.68,0
1686,110-PATNA,030373-Jawahar Navodaya Vidyalaya,4,19,16,3,7,9,84.21,36.84
1687,105-CHANDIGARH,050149-Saint Nischal Sr.sec.school,5,19,19,0,5,14,100,26.32
1688,107-DELHI,270353-Spring Meadows Public School,4,19,17,2,17,0,89.47,89.47
1689,120-RANCHI,260144-S.s. +2 High School,4,19,19,0,19,0,100,100
1690,109-JAIPUR,170407-JANKI DEVI MEMORIAL PUBLIC SCHOOL,4,19,19,0,16,3,100,84.21
1691,114-DEHRADUN,M38193-Madarsa Babul Ilm,4,19,0,19,0,0,0,0
1692,107-DELHI,050629-Golden Valley International School,4,19,0,19,0,0,0,0
1693,107-DELHI,050179-Adarsh Janta Sr.sec.school,4,19,0,19,0,0,0,0
1694,109-JAIPUR,170018-Kendriya Vidyalaya No. 1,4,19,12,7,4,8,63.16,21.05
1695,109-JAIPUR,V17001-SMT. MOHARI DEVI TAPARIA VED VIDYALAYA SAMITI,4,19,19,0,7,12,100,36.84
1696,105-CHANDIGARH,160065-St.kabir Convent School,3,19,19,0,19,0,100,100
1697,109-JAIPUR,170004-Sophia Sr.hr.sec.school,5,19,16,3,12,4,84.21,63.16
1698,107-DELHI,050584-RBSM PUBLIC SCHOOL,4,19,0,19,0,0,0,0
1699,105-CHANDIGARH,050603-M.S Saraswati Sr. sec. School,4,19,19,0,8,11,100,42.11
1700,114-DEHRADUN,210348-Tiny Tots College,5,18,16,2,16,0,88.89,88.89
1701,101-HYDERABAD,M47181-Azaan International School,6,18,18,0,18,0,100,100
1702,111-ALLAHABAD/PRAYAGRAJ,210321-Dr.s.radha Krishnan Public Inter,5,18,10,8,1,9,55.56,5.56
1703,105-CHANDIGARH,050548-BKN Public School,4,18,18,0,6,12,100,33.33
1704,111-ALLAHABAD/PRAYAGRAJ,210483-Jawahar Navodaya Vidyalaya,4,18,8,10,1,7,44.44,5.56
1705,119-RAIPUR,M29055-The Jain International School,4,18,0,18,0,0,0,0
1706,114-DEHRADUN,340265-J.b. Memorial Academy,5,18,18,0,18,0,100,100
1707,107-DELHI,270450-Aristotle Public School,4,18,0,18,0,0,0,0
1708,109-JAIPUR,170232-S.m.m. Govt. Girl's Hr.sec. School,3,18,14,4,6,8,77.78,33.33
1709,113-BHOPAL,100006-Kendriya Vidyalaya,4,18,0,18,0,0,0,0
1710,125-JAMMU,070044-Vishaw Jyoti Shishu Niketan H.s.,4,18,3,15,0,3,16.67,0
1711,115-BHUBANESWAR,150185-Birsa Munda Vidyapitha,6,18,17,1,8,9,94.44,44.44
1712,122-DHARAMSALA,060018-Govt. Boys Sr. Sec. School,5,18,18,0,4,14,100,22.22
1713,114-DEHRADUN,340121-Govt. Inter College,4,18,18,0,18,0,100,100
1714,121-CHENNAI,190114-S.s.v.m. World School,5,18,0,18,0,0,0,0
1715,104-GUWAHATI,M02048-Sacred Heart School,4,18,18,0,18,0,100,100
1716,111-ALLAHABAD/PRAYAGRAJ,210116-Holy Faith Inter College,4,18,8,10,3,5,44.44,16.67
1717,125-JAMMU,M07051-Sri Guru Govind Singh Public,4,18,9,9,5,4,50,27.78
1718,113-BHOPAL,100172-Bal Bharti Public School,4,18,0,18,0,0,0,0
1719,110-PATNA,030250-Govt. Higher Secondary School,4,18,13,5,1,12,72.22,5.56
1720,109-JAIPUR,170112-Shree Rishikul Secondary School,4,17,17,0,4,13,100,23.53
1721,105-CHANDIGARH,050644-Green Valley International School,4,17,17,0,9,8,100,52.94
1722,113-BHOPAL,M10278-St. Joseph's Convent Senior Sec. School,3,17,17,0,14,3,100,82.35
1723,102-PUNE,110029-St.joseph Convent Girls High School,4,17,17,0,16,1,100,94.12
1724,110-PATNA,450082-Mukti Niketan Bhagalpur,4,17,17,0,1,16,100,5.88
1725,114-DEHRADUN,210777-Chetna Junior High School,3,17,17,0,17,0,100,100
1726,110-PATNA,030287-P.n.anglo Sanskrit Ucch Vidyalaya,4,17,12,5,2,10,70.59,11.76
1727,105-CHANDIGARH,050206-A.P. Garg Public School,4,17,17,0,3,14,100,17.65
1728,119-RAIPUR,290170-Dr. Milap Ram Sahu Vidhyalaya (M.R.S.V),5,17,3,14,0,3,17.65,0
1729,111-ALLAHABAD/PRAYAGRAJ,210278-Jai Devi Awasthi Inter College,3,17,9,8,4,5,52.94,23.53
1730,121-CHENNAI,190015-Maharishi Vidya Mandir,3,17,0,17,0,0,0,0
1731,110-PATNA,"030251-Raj High School,",4,17,17,0,17,0,100,100
1732,105-CHANDIGARH,050604-Holy Wisdom Convent,3,17,17,0,3,14,100,17.65
1733,118-GANDHINAGAR,390091-M.B. Patel Gyanjot Vidhya Vihar,4,17,17,0,13,4,100,76.47
1734,105-CHANDIGARH,050564-M.D.S PUBLIC SCHOOL,4,17,17,0,17,0,100,100
1735,106-KOCHI,090072-Panchayat H.s.s.,4,17,17,0,7,10,100,41.18
1736,104-GUWAHATI,200013-B.b.institution,5,17,17,0,17,0,100,100
1737,121-CHENNAI,190161-Sri Sankara Matriculation Hr. Sec. School,3,16,16,0,1,15,100,6.25
1738,110-PATNA,030116-Kiddy Convent High School,3,16,10,6,0,10,62.5,0
1739,103-KOLKATA,220112-Kendriya Vidyalaya,4,16,0,16,0,0,0,0
1740,107-DELHI,270560-Guru Angad Public School,4,16,0,16,0,0,0,0
1741,113-BHOPAL,100019-Chattrapati Shivaji Sr.sec Public,5,16,0,16,0,0,0,0
1742,105-CHANDIGARH,050646-Army Public School,4,16,16,0,13,3,100,81.25
1743,114-DEHRADUN,210614-Gyandeep Higher Secondary School,4,16,0,16,0,0,0,0
1744,118-GANDHINAGAR,040073-GAJERA INTERNATIONAL SCHOOL,4,16,16,0,6,10,100,37.5
1745,106-KOCHI,M40073-St. John's Public School,3,16,16,0,6,10,100,37.5
1746,111-ALLAHABAD/PRAYAGRAJ,210022-Jawahar Navodaya Vidyalaya,4,16,9,7,2,7,56.25,12.5
1747,114-DEHRADUN,210790-Vibgyor School,4,16,16,0,0,16,100,0
1748,121-CHENNAI,190159-Anugragha International School,3,16,0,16,0,0,0,0
1749,102-PUNE,110136-Kendriya Vidyalaya No.1,4,16,16,0,16,0,100,100
1750,104-GUWAHATI,"240009-Govt. Hr. Sec. School, Khonsa",4,16,16,0,14,2,100,87.5
1751,104-GUWAHATI,020062-Sreeram Academy,4,16,16,0,7,9,100,43.75
1752,120-RANCHI,260190-Star International School,5,16,16,0,15,1,100,93.75
1753,107-DELHI,050544-S.D.M PUBLIC SCHOOL ,3,16,16,0,8,8,100,50
1754,110-PATNA,030375-Jawahar Navodaya Vidyalaya,3,16,13,3,6,7,81.25,37.5
1755,105-CHANDIGARH,320202-HRDC Hq 2 Corps,3,16,14,2,9,5,87.5,56.25
1756,105-CHANDIGARH,050069-Nav Bharat High School,3,16,16,0,16,0,100,100
1757,110-PATNA,030313-Marwari +2 Ucchater Vidyalaya,3,16,14,2,0,14,87.5,0
1758,107-DELHI,270553-White Leaf Public School,3,16,0,16,0,0,0,0
1759,105-CHANDIGARH,160121-Dashmesh Public Sr.Sec. School,4,16,16,0,5,11,100,31.25
1760,115-BHUBANESWAR,T15015-Komand Private Industrial Training Institute,3,16,16,0,13,3,100,81.25
1761,110-PATNA,030413-Shanti Mission Academy,3,16,12,4,5,7,75,31.25
1762,118-GANDHINAGAR,040067-Delhi Public School,3,16,16,0,13,3,100,81.25
1763,103-KOLKATA,220106-Rabindranath Higher Sec. School,3,16,16,0,16,0,100,100
1764,104-GUWAHATI,240002-Govt. Hr. Sec.school,4,16,16,0,10,6,100,62.5
1765,113-BHOPAL,100272-Sakshi High School,4,16,16,0,4,12,100,25
1766,118-GANDHINAGAR,040036-Shree Amrita Academy Higher,3,16,16,0,16,0,100,100
1767,102-PUNE,M11113-St. Marys Convent School Jr college,3,16,16,0,13,3,100,81.25
1768,104-GUWAHATI,440005-Sai Rns Academy,3,16,16,0,12,4,100,75
1769,125-JAMMU,070059-Tiny Tots Hr.Sec. School,3,16,3,13,0,3,18.75,0
1770,109-JAIPUR,170376-Name 4347,3,16,7,9,1,6,43.75,6.25
1771,116-VISAKHAPATNAM,010164-Kendriya Vidyalaya No.1,4,16,15,1,15,0,93.75,93.75
1772,113-BHOPAL,100245-St. Paul Convent Hr. Sec. School,3,16,16,0,16,0,100,100
1773,114-DEHRADUN,210050-National Muslim Academy,3,16,16,0,16,0,100,100
1774,105-CHANDIGARH,160132-Delhi Public School,3,16,14,2,4,10,87.5,25
1775,105-CHANDIGARH,050325-Arya Sr.sec.school,3,16,16,0,11,5,100,68.75
1776,118-GANDHINAGAR,040044-Kendriya Vidyalaya,3,16,16,0,11,5,100,68.75
1777,109-JAIPUR,M45090-St. Francis Sr. Sec. School (Tanwar Shikshan Sansthan),3,16,15,1,12,3,93.75,75
1778,114-DEHRADUN,340302-Govt. Inter College,4,15,15,0,15,0,100,100
1779,104-GUWAHATI,M13020-Auxilium Umpohliew Jingstad Secondary School,3,15,15,0,12,3,100,80
1780,105-CHANDIGARH,160128-Anuvarat Public Sr.Sec. School,3,15,15,0,10,5,100,66.67
1781,105-CHANDIGARH,050562-Harkishan Memorial Public School,4,15,15,0,8,7,100,53.33
1782,113-BHOPAL,100058-Krishna Higher Sec. School,3,15,0,15,0,0,0,0
1783,107-DELHI,050257-Kitty Garden Sr.sec.school,3,15,0,15,0,0,0,0
1784,121-CHENNAI,"190086-Kendriya Vidyalaya, Hdf",3,15,0,15,0,0,0,0
1785,121-CHENNAI,M19104-Asian Christian High School,3,15,15,0,15,0,100,100
1786,115-BHUBANESWAR,150198-Kerala English Medium School,6,15,12,3,7,5,80,46.67
1787,114-DEHRADUN,210254-Divine Inter College,3,15,0,15,0,0,0,0
1788,121-CHENNAI,190085-Kandriya Vidyalaya,3,15,15,0,0,15,100,0
1789,110-PATNA,030012-Jawahar Navodaya Vidyalaya,4,15,12,3,0,12,80,0
1790,121-CHENNAI,190106-H.L.C. International,3,15,15,0,14,1,100,93.33
1791,117-BENGALURU,080041-Jawahar Navodaya Vidyalaya,3,15,15,0,4,11,100,26.67
1792,110-PATNA,030244-Govt. Girls Higher Secondary School,3,15,15,0,2,13,100,13.33
1793,107-DELHI,450073-Katha School Of Entrepreneurship,3,15,13,2,0,13,86.67,0
1794,102-PUNE,110060-New Modern English High School,4,15,15,0,15,0,100,100
1795,106-KOCHI,400027-Vyas Vidya Peethom,4,15,15,0,15,0,100,100
1796,103-KOLKATA,230010-Govt. Rabindra Bangla Vidyalaya,3,15,0,15,0,0,0,0
1797,121-CHENNAI,190036-Kendriya Vidyalaya,4,15,0,15,0,0,0,0
1798,105-CHANDIGARH,050508-Gitanjali Sr.Sec. School,3,15,15,0,15,0,100,100
1799,110-PATNA,030064-Zila School,3,15,15,0,0,15,100,0
1800,105-CHANDIGARH,050351-Bhagwan Parshu Ram Sr.sec. School,3,15,15,0,8,7,100,53.33
1801,103-KOLKATA,220026-North Point Sr Sec.school,3,15,0,15,0,0,0,0
1802,103-KOLKATA,180017-Govt. Senior Secondary School,3,15,14,1,14,0,93.33,93.33
1803,107-DELHI,270536-Khemo Devi Public School,3,15,0,15,0,0,0,0
1804,121-CHENNAI,190075-Govt. Girls Hr.sec. School,6,15,0,15,0,0,0,0
1805,110-PATNA,030194-G.m.s.s. Ucch Vidyalaya,3,15,15,0,7,8,100,46.67
1806,111-ALLAHABAD/PRAYAGRAJ,210119-Bal Vidyalaya Madhyamik School,3,15,13,2,6,7,86.67,40
1807,120-RANCHI,260103-+2 High School,3,15,15,0,14,1,100,93.33
1808,115-BHUBANESWAR,"150182-Zila High School, Puri, Odisha",3,15,9,6,6,3,60,40
1809,114-DEHRADUN,340140-Moravian Institute,8,15,6,9,5,1,40,33.33
1810,107-DELHI,270365-Govt.co-education Secondary School,4,15,0,15,0,0,0,0
1811,123-GANGTOK,180020-Govt. Senior Secondary School,3,15,0,15,0,0,0,0
1812,111-ALLAHABAD/PRAYAGRAJ,210259-Jan Kalyan Shiksha Samiti,3,15,6,9,0,6,40,0
1813,111-ALLAHABAD/PRAYAGRAJ,210525-Hare Krishna Public School,3,15,6,9,0,6,40,0
1814,107-DELHI,210520-NIMT B SCHOOL,4,15,0,15,0,0,0,0
1815,104-GUWAHATI,440002-Rongkut Khorsing High School,3,15,15,0,11,4,100,73.33
1816,101-HYDERABAD,470186-Kendriya Vidyalaya,4,15,1,14,0,1,6.67,0
1817,117-BENGALURU,480004-Spastic Society Of Karnataka,6,15,15,0,14,1,100,93.33
1818,106-KOCHI,400064-Raja Rajeswari Senior Sec.school,3,14,14,0,8,6,100,57.14
1819,125-JAMMU,070034-Jawahar Navodaya Vidyalaya,5,14,14,0,13,1,100,92.86
1820,120-RANCHI,260034-Neta Ji Subhas Public School,3,14,0,14,0,0,0,0
1821,117-BENGALURU,480002-St. Ann's High School,4,14,14,0,11,3,100,78.57
1822,107-DELHI,050615-Modern International Sr. Sec. School,3,14,0,14,0,0,0,0
1823,107-DELHI,270541-Rural Complex For Complete Education (RCCE) Public School,4,14,1,13,0,1,7.14,0
1824,121-CHENNAI,190043-Little Kingdom School,3,14,0,14,0,0,0,0
1825,121-CHENNAI,190119-Aristo Public School,4,14,14,0,8,6,100,57.14
1826,107-DELHI,270331-Shibban Modern Public Sec. School,3,14,0,14,0,0,0,0
1827,119-RAIPUR,290173-Krishna Public School,3,14,12,2,5,7,85.71,35.71
1828,109-JAIPUR,170296-Abhinav Senior Secondary School,2,14,12,2,3,9,85.71,21.43
1829,111-ALLAHABAD/PRAYAGRAJ,210477-Kamla Higher Secondary School,3,14,14,0,14,0,100,100
1830,118-GANDHINAGAR,390159-Glorious Public School,2,14,14,0,12,2,100,85.71
1831,122-DHARAMSALA,060020-Govt. Senior Secondary School,4,14,8,6,0,8,57.14,0
1832,113-BHOPAL,"100126-Kendriya Vidyalaya, No.2",3,14,0,14,0,0,0,0
1833,116-VISAKHAPATNAM,010172-Kendriya Vidyalaya,3,14,14,0,14,0,100,100
1834,102-PUNE,110107-Kendriya Vidyalaya,3,14,14,0,14,0,100,100
1835,111-ALLAHABAD/PRAYAGRAJ,210052-Springdale College,3,14,14,0,0,14,100,0
1836,110-PATNA,"030063-G.a.inter School,",3,14,8,6,0,8,57.14,0
1837,109-JAIPUR,170019-Kendriya Vidyalaya No-1,3,14,11,3,4,7,78.57,28.57
1838,114-DEHRADUN,340293-RAJEEV GANDHI NAVODAYA VIDYALAYA,3,14,4,10,3,1,28.57,21.43
1839,104-GUWAHATI,020002-Rupnagar Vidyapeeth High School,3,14,14,0,6,8,100,42.86
1840,113-BHOPAL,M10229-Aaps (ashaskiya The Akshya Academy),3,14,0,14,0,0,0,0
1841,109-JAIPUR,170289-Aakansha International School,3,14,14,0,7,7,100,50
1842,107-DELHI,270511-New Krishna Model Public School ,3,14,5,9,0,5,35.71,0
1843,105-CHANDIGARH,050446-Green Valley Sr. Sec. School,3,14,14,0,6,8,100,42.86
1844,104-GUWAHATI,130029-Army Public School,3,14,14,0,9,5,100,64.29
1845,105-CHANDIGARH,050520-Datta Public School,3,14,14,0,1,13,100,7.14
1846,121-CHENNAI,310012-K S P International Higher Secondary School,3,14,0,14,0,0,0,0
1847,105-CHANDIGARH,050236-Red Roses Public Sr. Sec. School,3,14,14,0,14,0,100,100
1848,114-DEHRADUN,210806-LTR Public School,3,14,14,0,14,0,100,100
1849,114-DEHRADUN,210372-Kendriya Vidyalaya,4,14,0,14,0,0,0,0
1850,123-GANGTOK,180006-Kendriya Vidyalaya,3,13,10,3,6,4,76.92,46.15
1851,110-PATNA,030043-Saraswati Vidya Mandir,3,13,13,0,1,12,100,7.69
1852,109-JAIPUR,170357-Dr. Bansi Dhar School,3,13,10,3,1,9,76.92,7.69
1853,122-DHARAMSALA,060077-Jawahar Navodaya Vidyalaya,3,13,6,7,6,0,46.15,46.15
1854,120-RANCHI,320608-HQ 10 Corps Hrdc,3,13,0,13,0,0,0,0
1855,111-ALLAHABAD/PRAYAGRAJ,210154-D.K.Inter College,3,13,7,6,1,6,53.85,7.69
1856,110-PATNA,030377-Jawahar Navodaya Vidyalaya,3,13,6,7,1,5,46.15,7.69
1857,105-CHANDIGARH,050624-Sun Rise Senior Secondary School,3,13,13,0,7,6,100,53.85
1858,121-CHENNAI,190140-The Indian Public School,6,13,11,2,11,0,84.62,84.62
1859,103-KOLKATA,230012-Govt. Senior Secondary School,4,13,0,13,0,0,0,0
1860,119-RAIPUR,290047-Kendriya Vidyalaya,3,13,0,13,0,0,0,0
1861,111-ALLAHABAD/PRAYAGRAJ,210554-Study Well Public School,3,13,5,8,1,4,38.46,7.69
1862,111-ALLAHABAD/PRAYAGRAJ,210415-Jawahar Navodaya Vidyalaya,6,13,5,8,0,5,38.46,0
1863,105-CHANDIGARH,050116-Mamta Girls Senior Secondary School,3,13,13,0,6,7,100,46.15
1864,106-KOCHI,090083-Holy Trinity School,4,13,13,0,5,8,100,38.46
1865,120-RANCHI,260201-CHHOTA NAGPUR INTER COLLEGE,3,13,13,0,12,1,100,92.31
1866,101-HYDERABAD,M01195-Mannu Model School ,4,13,13,0,13,0,100,100
1867,102-PUNE,110108-Kendriya Vidyalaya,3,13,12,1,12,0,92.31,92.31
1868,111-ALLAHABAD/PRAYAGRAJ,210056-Jawahar Navodaya Vidyalaya,4,13,6,7,0,6,46.15,0
1869,110-PATNA,030083-Hit Narayan Kshatriya +2 Vidyalaya,3,13,9,4,0,9,69.23,0
1870,115-BHUBANESWAR,"150193-Kendriya Vidyalaya, Bhadrak",4,13,13,0,10,3,100,76.92
1871,109-JAIPUR,170362-Alpha Public Senior Sec. School,3,13,13,0,3,10,100,23.08
1872,109-JAIPUR,170195-Govt. Sr. Sec. School,3,13,10,3,5,5,76.92,38.46
1873,104-GUWAHATI,"M02042-Montfort High School, Chabua",3,13,13,0,13,0,100,100
1874,107-DELHI,450177-NOIDA Deaf Society,3,13,13,0,13,0,100,100
1875,107-DELHI,"270386-D.c.convent Secondary School,",3,13,5,8,0,5,38.46,0
1876,106-KOCHI,M40057-Mit Trust English Medium School,3,13,13,0,5,8,100,38.46
1877,123-GANGTOK,180007-Himalayan Pharmecy Institute,3,13,13,0,13,0,100,100
1878,105-CHANDIGARH,160031-St.soldiers Inter College,5,13,12,1,2,10,92.31,15.38
1879,101-HYDERABAD,M47185-St. PETERS EDU SCHOOL,3,13,13,0,13,0,100,100
1880,121-CHENNAI,190123-Kendriya Vidyalaya,3,13,13,0,13,0,100,100
1881,118-GANDHINAGAR,040029-Kendriya Vidyalaya,4,13,13,0,13,0,100,100
1882,110-PATNA,030262-R.d.h.+2 School,4,12,8,4,0,8,66.67,0
1883,104-GUWAHATI,130026-Ramakrishna Mission Hr.Sec. School,2,12,11,1,10,1,91.67,83.33
1884,102-PUNE,110034-Yashwant Vidyapeeth Karad,3,12,12,0,6,6,100,50
1885,111-ALLAHABAD/PRAYAGRAJ,210714-Ved Prakash Pathak Public School,3,12,9,3,2,7,75,16.67
1886,109-JAIPUR,170111-Nehru Public Sr.sec.school,2,12,12,0,3,9,100,25
1887,118-GANDHINAGAR,040072-NAND VIDYA NIKETAN,2,12,12,0,7,5,100,58.33
1888,105-CHANDIGARH,J16007-Central Jail,3,12,12,0,11,1,100,91.67
1889,114-DEHRADUN,340106-Govt. Inter College,4,12,12,0,12,0,100,100
1890,114-DEHRADUN,210570-Mother India Inter College,3,12,12,0,12,0,100,100
1891,105-CHANDIGARH,050510-Brahmi Janta Sr. Sec. School,2,12,10,2,1,9,83.33,8.33
1892,113-BHOPAL,100007-Kendriya Vidyalaya,3,12,10,2,10,0,83.33,83.33
1893,114-DEHRADUN,210201-Rajani Public School,3,12,0,12,0,0,0,0
1894,105-CHANDIGARH,050535-Guru Dronacharya Public School,3,12,12,0,8,4,100,66.67
1895,114-DEHRADUN,340312-Uttranchal Children's Academy Senior Secondary School,3,12,0,12,0,0,0,0
1896,120-RANCHI,260029-Sido Kohhu High School,2,12,0,12,0,0,0,0
1897,110-PATNA,030199-B S S Conigaite +2 School,3,12,10,2,2,8,83.33,16.67
1898,118-GANDHINAGAR,040038-Government Higher Secondary School,3,12,12,0,5,7,100,41.67
1899,120-RANCHI,260147-+2 Govt. Girls High School,2,12,0,12,0,0,0,0
1900,117-BENGALURU,"320410-Hrdc, Hq K&k Sub Area,",2,12,12,0,5,7,100,41.67
1901,107-DELHI,050643-Fogaat Public Sr. Sec. School,3,12,0,12,0,0,0,0
1902,113-BHOPAL,100124-Kendriya Vidyalaya,3,12,0,12,0,0,0,0
1903,122-DHARAMSALA,M06001-New Crescent Sr.sec. School,3,12,12,0,5,7,100,41.67
1904,111-ALLAHABAD/PRAYAGRAJ,210126-Rosy School,2,12,7,5,4,3,58.33,33.33
1905,105-CHANDIGARH,050246-S. K. Sr. Sec School,3,12,12,0,6,6,100,50
1906,103-KOLKATA,M22094-Belur T.h. Memorial Urdu Higher,3,12,0,12,0,0,0,0
1907,111-ALLAHABAD/PRAYAGRAJ,"M21296-Milton Public School,",3,12,9,3,6,3,75,50
1908,101-HYDERABAD,380119-Al-Ameen Educational Society,4,12,12,0,12,0,100,100
1909,114-DEHRADUN,340273-Govt. Inter College,3,12,12,0,12,0,100,100
1910,114-DEHRADUN,340306-Raiwal Mil Station,3,12,0,12,0,0,0,0
1911,111-ALLAHABAD/PRAYAGRAJ,210798-Radha Krishna Memorial Education Centre,3,12,10,2,2,8,83.33,16.67
1912,110-PATNA,030192-Kajariwal Ucch Vidyalaya,3,12,12,0,2,10,100,16.67
1913,103-KOLKATA,450178-North Bengal Central School,2,12,12,0,12,0,100,100
1914,121-CHENNAI,190113-PADMASUBRAMANIAM BALABHAVAN,3,12,12,0,12,0,100,100
1915,113-BHOPAL,100031-Maharishi Vidya Mandir,3,12,12,0,3,9,100,25
1916,121-CHENNAI,190031-Kendriya Vidyalaya,3,12,9,3,9,0,75,75
1917,121-CHENNAI,190095-Kendriya Vidyalaya,2,11,0,11,0,0,0,0
1918,120-RANCHI,260119-+2 J.k. High School,2,11,0,11,0,0,0,0
1919,109-JAIPUR,170176-Swatantrata Sainani Chiranji Lal,2,11,11,0,11,0,100,100
1920,114-DEHRADUN,M38312-Rehmania Inter College,2,11,11,0,0,11,100,0
1921,114-DEHRADUN,340224-Govt. Junior College,2,11,0,11,0,0,0,0
1922,110-PATNA,"030072-B.p.ucch Vidyalaya,",3,11,8,3,0,8,72.73,0
1923,107-DELHI,050618-JCM International School,2,11,0,11,0,0,0,0
1924,110-PATNA,030042-Adwaita Mission High School,2,11,11,0,10,1,100,90.91
1925,111-ALLAHABAD/PRAYAGRAJ,210422-A P S Academy,3,11,5,6,3,2,45.45,27.27
1926,102-PUNE,110118-Jawahar Navodaya Vidyalaya,2,11,11,0,11,0,100,100
1927,107-DELHI,M05446-Iqraa Public School,2,11,11,0,3,8,100,27.27
1928,113-BHOPAL,100011-Kendriya Vidyalaya No.1,2,11,0,11,0,0,0,0
1929,111-ALLAHABAD/PRAYAGRAJ,210482-Kendriya Vidyalaya,2,11,5,6,0,5,45.45,0
1930,123-GANGTOK,220063-Goethal Memorial School,2,11,11,0,11,0,100,100
1931,107-DELHI,050614-Shaheed Amar Singh Public School,3,11,9,2,0,9,81.82,0
1932,111-ALLAHABAD/PRAYAGRAJ,M21625-St. Mary's Convent Inter College,2,11,6,5,5,1,54.55,45.45
1933,102-PUNE,110116-Jawahar Navodaya Vidyalaya,3,11,11,0,11,0,100,100
1934,117-BENGALURU,080010-Divya Shanti High School,3,11,11,0,8,3,100,72.73
1935,102-PUNE,110063-J B Ludhani High School & Jr Colleg,3,11,11,0,11,0,100,100
1936,107-DELHI,M27480-Jai Hind Public School,2,11,0,11,0,0,0,0
1937,114-DEHRADUN,M34239-Rehmania Inter College,2,11,11,0,0,11,100,0
1938,121-CHENNAI,190155-KSR Akshara Academy,3,11,0,11,0,0,0,0
1939,107-DELHI,210727-Vidhan Public School,2,11,0,11,0,0,0,0
1940,120-RANCHI,260112-+2 High School,2,11,0,11,0,0,0,0
1941,108-ABROAD/NIOS HQ,950024-The Indian Community School,3,11,4,7,4,0,36.36,36.36
1942,118-GANDHINAGAR,040039-Nootan Bharti Vidyalaya,2,11,11,0,6,5,100,54.55
1943,111-ALLAHABAD/PRAYAGRAJ,210057-Kendriya Vidyalaya,2,11,9,2,2,7,81.82,18.18
1944,102-PUNE,110147-Army Public School,2,11,11,0,9,2,100,81.82
1945,104-GUWAHATI,020071-Kampur Adarsha High School,3,11,11,0,5,6,100,45.45
1946,109-JAIPUR,170261-Tagore Global International School,2,11,11,0,4,7,100,36.36
1947,105-CHANDIGARH,M16107-Aaban Public School,3,11,11,0,11,0,100,100
1948,109-JAIPUR,170156-Govt. Sr. Sec. School,3,11,10,1,3,7,90.91,27.27
1949,107-DELHI,"270391-Raghubir Singh Modern School,",2,11,0,11,0,0,0,0
1950,107-DELHI,M21561-St. Teresa Open School,3,11,0,11,0,0,0,0
1951,120-RANCHI,260107-S.s. +2 Vidyalaya,2,11,0,11,0,0,0,0
1952,122-DHARAMSALA,060013-Govt. Sr. Sec. School,2,11,0,11,0,0,0,0
1953,115-BHUBANESWAR,150081-Jawahar Navodaya Vidyalaya,3,11,11,0,8,3,100,72.73
1954,105-CHANDIGARH,050192-Shiv High School,2,11,11,0,0,11,100,0
1955,111-ALLAHABAD/PRAYAGRAJ,210728-B.G.B. Braj Education Academy,2,11,4,7,2,2,36.36,18.18
1956,102-PUNE,110144-Fravashi International Academy,3,11,11,0,10,1,100,90.91
1957,105-CHANDIGARH,050383-Megharam Public School,2,11,11,0,0,11,100,0
1958,117-BENGALURU,080062-Sri Adichundhangiri Eng.High School,4,11,11,0,10,1,100,90.91
1959,105-CHANDIGARH,050565-GLOBAL PUBLIC SCHOOL,2,11,11,0,2,9,100,18.18
1960,101-HYDERABAD,320417-Hq 54 Inf Div,2,11,10,1,10,0,90.91,90.91
1961,111-ALLAHABAD/PRAYAGRAJ,210721-Sacred Heart School,2,11,7,4,2,5,63.64,18.18
1962,103-KOLKATA,220126-Ramkrishna Vedanta Ashram Vidyamandir,2,11,0,11,0,0,0,0
1963,109-JAIPUR,170403-Maharaja Public Sr. Sec. School,2,11,11,0,5,6,100,45.45
1964,114-DEHRADUN,340317-Seedling School,2,10,0,10,0,0,0,0
1965,106-KOCHI,M40056-Noorul Huda Orphanage,2,10,10,0,4,6,100,40
1966,121-CHENNAI,420110-DAV Boys Sr. Secondary School,2,10,10,0,0,10,100,0
1967,105-CHANDIGARH,160029-St. Soldier Divine Public School,2,10,9,1,2,7,90,20
1968,123-GANGTOK,220101-Kendriya Vidyalaya,2,10,10,0,10,0,100,100
1969,107-DELHI,210673-K.C.S. Public Inter College,2,10,0,10,0,0,0,0
1970,103-KOLKATA,M38112-Belur T.h. Memorial Urdu Higher,4,10,0,10,0,0,0,0
1971,120-RANCHI,260167-S.s.+2 High School,2,10,0,10,0,0,0,0
1972,118-GANDHINAGAR,040027-Kendriya Vidyalaya,2,10,10,0,6,4,100,60
1973,116-VISAKHAPATNAM,010207-Vani Junior College,2,10,9,1,9,0,90,90
1974,114-DEHRADUN,340269-Govt. Inter College,2,10,0,10,0,0,0,0
1975,114-DEHRADUN,340300-Govt. Inter College,2,10,0,10,0,0,0,0
1976,115-BHUBANESWAR,410115-Centurion Public School,2,10,8,2,6,2,80,60
1977,114-DEHRADUN,M21230-F.d Islamia Inter College,2,10,4,6,0,4,40,0
1978,111-ALLAHABAD/PRAYAGRAJ,210576-Green Field Academy Sr.sec. School,2,10,4,6,0,4,40,0
1979,111-ALLAHABAD/PRAYAGRAJ,210745-K.V.N. Public School,3,10,10,0,10,0,100,100
1980,125-JAMMU,M07024-New Horizon Institute Of Secondary,2,10,3,7,0,3,30,0
1981,116-VISAKHAPATNAM,010199-Vinayaka High School,2,10,8,2,8,0,80,80
1982,120-RANCHI,260132-N.r. Govt. +2 H/s,2,10,0,10,0,0,0,0
1983,111-ALLAHABAD/PRAYAGRAJ,210713-R.R. Public School,2,10,7,3,3,4,70,30
1984,113-BHOPAL,100305-Ambedkar Smriti Higher Sec.School,2,10,0,10,0,0,0,0
1985,107-DELHI,450108-The Ashtavakra School (school For,2,10,10,0,10,0,100,100
1986,105-CHANDIGARH,050597-Lord Krishna Public School,2,10,9,1,3,6,90,30
1987,104-GUWAHATI,440011-Pranab Jubilee College,3,10,10,0,8,2,100,80
1988,120-RANCHI,260073-DAV Public School,3,10,10,0,8,2,100,80
1989,116-VISAKHAPATNAM,010195-Kendriya Vidyalaya,2,10,8,2,8,0,80,80
1990,109-JAIPUR,170370-Vidhya Sagar School,2,10,5,5,1,4,50,10
1991,111-ALLAHABAD/PRAYAGRAJ,210711-Baba Gurukul Academy,2,10,6,4,1,5,60,10
1992,111-ALLAHABAD/PRAYAGRAJ,320606-HQ 33 Armd Div,2,10,9,1,1,8,90,10
1993,105-CHANDIGARH,160098-Guru Teg Bahadur Public School,2,10,10,0,8,2,100,80
1994,111-ALLAHABAD/PRAYAGRAJ,210058-Annie Besant School,2,10,7,3,2,5,70,20
1995,111-ALLAHABAD/PRAYAGRAJ,210740-Cross Belly International School,2,10,4,6,3,1,40,30
1996,121-CHENNAI,190064-S.l.b. Govt. Hr. Sec. School,3,10,10,0,9,1,100,90
1997,116-VISAKHAPATNAM,010182-Sri Pragathi Junior College,2,10,10,0,10,0,100,100
1998,109-JAIPUR,170022-Kendriya Vidyalaya,2,10,7,3,3,4,70,30
1999,105-CHANDIGARH,050357-Modern Senior Secondary School,2,10,10,0,0,10,100,0
2000,109-JAIPUR,170442-Shri Krishna Secondary Public School,2,10,10,0,2,8,100,20
2001,104-GUWAHATI,M13011-St.paul's Secondary School,2,10,10,0,6,4,100,60
2002,109-JAIPUR,170106-Veer Teja Siksha Samiti Sr.sec.,2,10,9,1,3,6,90,30
2003,107-DELHI,050213-Navodaya Saraswati School,2,10,10,0,10,0,100,100
2004,121-CHENNAI,420093-Adhiparasakthi Annai Illam,2,10,10,0,2,8,100,20
2005,106-KOCHI,090025-K S Abdullah English Medium School,2,10,10,0,2,8,100,20
2006,107-DELHI,050528-Swamy Dharmanand Sr.Sec. School,3,10,0,10,0,0,0,0
2007,109-JAIPUR,170292-Shiksha High School,2,10,7,3,4,3,70,40
2008,102-PUNE,110146-Army Public School,2,10,10,0,10,0,100,100
2009,105-CHANDIGARH,050462-Gian Jyoti Senior Secondary School,3,10,10,0,4,6,100,40
2010,110-PATNA,030254-K.r.k.high School,2,10,10,0,0,10,100,0
2011,105-CHANDIGARH,160119-Shri Guru Arjan  Dev Sr.sec. School,2,10,10,0,10,0,100,100
2012,119-RAIPUR,290099-Govt. Model Ramanuj Hr. Sec.school,2,10,0,10,0,0,0,0
2013,105-CHANDIGARH,050424-C.r.b.v.m.senior Secondary School,2,10,10,0,2,8,100,20
2014,101-HYDERABAD,470001-Kendriya Vidyalaya,2,10,10,0,10,0,100,100
2015,107-DELHI,270373-Kalawati Vidya Bharti Public School,2,10,10,0,10,0,100,100
2016,109-JAIPUR,450152-Pratham Education Foundation,2,10,10,0,3,7,100,30
2017,125-JAMMU,070060-Army Public School,2,10,5,5,4,1,50,40
2018,109-JAIPUR,170304-Rajasthan Public Sr.sec. School,2,10,8,2,3,5,80,30
2019,101-HYDERABAD,470211-JAIN HERITAGE A CAMBRIDGE SCHOOL ,2,10,10,0,10,0,100,100
2020,121-CHENNAI,420006-Maharishi Vidya Mandir Senior,2,10,10,0,8,2,100,80
2021,121-CHENNAI,450174-National  Institute For Empowerment with Multiple Disabilities,2,10,10,0,0,10,100,0
2022,109-JAIPUR,170142-Govt. Sr.sec. School,2,10,7,3,3,4,70,30
2023,103-KOLKATA,180015-Govt. Senior Secondary School,2,10,10,0,10,0,100,100
2024,110-PATNA,030252-Rajkiya Chapman Balika(10+2)school,2,10,7,3,4,3,70,40
2025,103-KOLKATA,T22003-LUTHFA PRIVATE INDUSTRIAL,3,10,0,10,0,0,0,0
2026,107-DELHI,M21367-Nm Hr.sec.school,3,10,2,8,0,2,20,0
2027,107-DELHI,270438-S.d. Saraswati Bal Mandir,2,10,0,10,0,0,0,0
2028,118-GANDHINAGAR,040035-Atul Vidyalaya,2,10,10,0,6,4,100,60
2029,105-CHANDIGARH,050498-Nav Chetna Senior Secondary School,2,10,10,0,2,8,100,20
2030,118-GANDHINAGAR,040133-Shri V D Mayavanshi High School,2,10,10,0,6,4,100,60
2031,116-VISAKHAPATNAM,450171-New Sunflower Special School,2,10,10,0,9,1,100,90
2032,114-DEHRADUN,340305-Shishu Vidya Mandir,2,10,0,10,0,0,0,0
2033,109-JAIPUR,170118-Defence Public Senior Secondary,2,10,9,1,6,3,90,60
2034,102-PUNE,450006-A.j.n.inst.of Hearing Handicapped,2,10,10,0,8,2,100,80
2035,121-CHENNAI,190124-Brilliant School,2,10,0,10,0,0,0,0
2036,121-CHENNAI,190014-Shree Vidyalaya Mat.Hr.Sec.School,2,10,0,10,0,0,0,0
2037,109-JAIPUR,170152-Govt. Sr. Sec. School,2,10,10,0,6,4,100,60
2038,109-JAIPUR,170434-G.S Jangid Memorial School,2,10,10,0,10,0,100,100
2039,118-GANDHINAGAR,040092-Shree Swaminarayan International Gunatit Vidyadham,2,10,10,0,7,3,100,70
2040,105-CHANDIGARH,050134-Dewan Bal Krishan Public School,3,10,10,0,2,8,100,20
2041,105-CHANDIGARH,050519-Gayatri Public School,2,10,10,0,2,8,100,20
2042,118-GANDHINAGAR,390076-Sardar Public School,2,10,10,0,10,0,100,100
2043,105-CHANDIGARH,050227-Cr Sr. Sec. School,2,10,10,0,0,10,100,0
2044,109-JAIPUR,170151-Govt. Sr. Sec. School,2,10,6,4,1,5,60,10
2045,113-BHOPAL,100022-Jawahar Navodaya Vidyalaya,2,9,0,9,0,0,0,0
2046,105-CHANDIGARH,050043-Kamla Montessori School,2,9,9,0,4,5,100,44.44
2047,121-CHENNAI,190051-Govt. Higher Sec. School,2,9,0,9,0,0,0,0
2048,120-RANCHI,260038-B.n.saha D.a.v. Public School,2,9,9,0,9,0,100,100
2049,105-CHANDIGARH,050600-Kite International Public School,2,9,9,0,4,5,100,44.44
2050,109-JAIPUR,170092-Kendriya Vidyalaya,2,9,6,3,3,3,66.67,33.33
2051,119-RAIPUR,290141-Govt. Higher Secondary School,2,9,0,9,0,0,0,0
2052,111-ALLAHABAD/PRAYAGRAJ,210656-Morning Star Children's Academy,2,9,8,1,1,7,88.89,11.11
2053,111-ALLAHABAD/PRAYAGRAJ,M21472-Alpsankhyak Aqsa Public Inter,2,9,7,2,3,4,77.78,33.33
2054,111-ALLAHABAD/PRAYAGRAJ,210071-Kendriya Vidyalaya,2,9,7,2,1,6,77.78,11.11
2055,105-CHANDIGARH,050547-Rao Ramchander Memorial Public Sch.,2,9,9,0,3,6,100,33.33
2056,116-VISAKHAPATNAM,010121-N. V. R. Junior College,2,9,6,3,6,0,66.67,66.67
2057,106-KOCHI,090089-Model Public School,2,9,9,0,3,6,100,33.33
2058,105-CHANDIGARH,160101-Mother India Public School,2,9,9,0,5,4,100,55.56
2059,105-CHANDIGARH,050393-St. Paul Bharti School,2,9,8,1,5,3,88.89,55.56
2060,114-DEHRADUN,340125-Govt. Inter College,3,9,3,6,3,0,33.33,33.33
2061,103-KOLKATA,220097-Modella Caretaker Centre & School,2,9,0,9,0,0,0,0
2062,102-PUNE,110031-Montfort Higher Sec. School,2,9,9,0,9,0,100,100
2063,113-BHOPAL,M10089-Bright Star Hr.sec.school,2,9,0,9,0,0,0,0
2064,118-GANDHINAGAR,040056-Bansidhar Vidyalaya,2,9,9,0,8,1,100,88.89
2065,114-DEHRADUN,340023-Jawahar Navodaya Vidyalaya,3,9,0,9,0,0,0,0
2066,121-CHENNAI,420100-Navalar Nedunchezhian Govt.Hr.Sec.School,2,9,0,9,0,0,0,0
2067,109-JAIPUR,170410-Bhagwani Devi Shikshan Sansthan,2,9,9,0,6,3,100,66.67
2068,109-JAIPUR,170264-Maharishi Dayanand Public School,2,9,4,5,1,3,44.44,11.11
2069,121-CHENNAI,190134-BVM GLOBAL BOLLINENI HILLSIDE SENIOR SECONDARY SCHOOL,2,9,9,0,5,4,100,55.56
2070,109-JAIPUR,170165-Govt. Higher Sec. School,2,9,4,5,0,4,44.44,0
2071,114-DEHRADUN,340018-Jawahar Navodaya Vidyalaya,2,9,0,9,0,0,0,0
2072,110-PATNA,030010-Jawahar Navodaya Vidyalaya,2,9,6,3,0,6,66.67,0
2073,114-DEHRADUN,340184-Sateswary Devi Memorial Public School,2,9,0,9,0,0,0,0
2074,105-CHANDIGARH,050269-L.c.r.t Public School,2,9,9,0,0,9,100,0
2075,120-RANCHI,260089-Jawahar Navodaya Vidyalaya,2,9,0,9,0,0,0,0
2076,107-DELHI,270475-Gyan Jyoti Public School,2,9,9,0,0,9,100,0
2077,114-DEHRADUN,340275-Super Inter College,2,9,9,0,9,0,100,100
2078,119-RAIPUR,290171-Adwani Oerlikon Govt. H.S. School,3,9,0,9,0,0,0,0
2079,109-JAIPUR,170408-Dahdimati International Sr. Sec. School,2,9,7,2,3,4,77.78,33.33
2080,104-GUWAHATI,M02075-Adarsha Vidyapith Beluguri,2,9,9,0,8,1,100,88.89
2081,109-JAIPUR,M17271-Al Suffah Academy Public School,2,9,9,0,9,0,100,100
2082,105-CHANDIGARH,050656-National Sr. Sec. School,2,9,9,0,3,6,100,33.33
2083,113-BHOPAL,M10264-Amreen Higher Secondary School,2,9,0,9,0,0,0,0
2084,107-DELHI,050594-Aakash International School,2,9,3,6,1,2,33.33,11.11
2085,121-CHENNAI,190017-Kennedy Matriculation Higher Sec,2,9,9,0,2,7,100,22.22
2086,111-ALLAHABAD/PRAYAGRAJ,210159-Dr.amrit Lal Ishrat,2,9,9,0,9,0,100,100
2087,115-BHUBANESWAR,410124-Jawahar Navodaya Vidyalaya,3,9,9,0,7,2,100,77.78
2088,102-PUNE,M36147-St.paul's English School&jr.college,2,9,9,0,7,2,100,77.78
2089,107-DELHI,270248-Bharat National Public School,2,9,0,9,0,0,0,0
2090,109-JAIPUR,170345-Sunrise Sr.sec. Public School,2,9,9,0,2,7,100,22.22
2091,109-JAIPUR,170153-Govt. Hr. Sec. School,2,9,8,1,2,6,88.89,22.22
2092,105-CHANDIGARH,160161-Atma Ram Memorial Convent School,2,9,9,0,3,6,100,33.33
2093,125-JAMMU,M38320-Muslim Institute Of Education,2,9,0,9,0,0,0,0
2094,115-BHUBANESWAR,150188-Centurion Public School,2,9,9,0,3,6,100,33.33
2095,105-CHANDIGARH,050530-Maharishi International Public Sch.,2,9,9,0,3,6,100,33.33
2096,105-CHANDIGARH,M16102-Sant Baba Attar Singh Public School,2,9,8,1,5,3,88.89,55.56
2097,113-BHOPAL,100109-Saraswati Gyan Mandir High School,2,9,0,9,0,0,0,0
2098,111-ALLAHABAD/PRAYAGRAJ,210432-Jawahar Navodaya Vidyalaya,2,9,8,1,5,3,88.89,55.56
2099,106-KOCHI,M09095-A.u.p. School,2,9,9,0,8,1,100,88.89
2100,115-BHUBANESWAR,150204-Dronacharya School,2,9,4,5,4,0,44.44,44.44
2101,111-ALLAHABAD/PRAYAGRAJ,M21286-St. Jude's Inter College,2,9,3,6,1,2,33.33,11.11
2102,103-KOLKATA,220102-Kendriya Vidyalaya,2,9,0,9,0,0,0,0
2103,121-CHENNAI,420112-Sri Sankara Vidyalaya Mat. Hr. Sec. School,2,9,9,0,0,9,100,0
2104,120-RANCHI,"450175-Deepsikha, ICD & MH",2,9,0,9,0,0,0,0
2105,102-PUNE,TM2801-Montfort Industrial Training Institute,2,9,9,0,9,0,100,100
2106,104-GUWAHATI,200030-Manughat Class Xii School,2,9,9,0,6,3,100,66.67
2107,111-ALLAHABAD/PRAYAGRAJ,210794-Shri Mahipal Shastri Inter College,2,9,6,3,2,4,66.67,22.22
2108,104-GUWAHATI,240029-Govt. Higher Secondary School,2,9,9,0,8,1,100,88.89
2109,106-KOCHI,T09001-Govt. ITI Kalamassery,4,8,8,0,5,3,100,62.5
2110,110-PATNA,030261-R.b.+2 Inter School,2,8,6,2,0,6,75,0
2111,105-CHANDIGARH,160152-Cambridge Convent High School,2,8,8,0,8,0,100,100
2112,102-PUNE,110150-Orchids The International School,2,8,8,0,7,1,100,87.5
2113,102-PUNE,M38333-Salahuddin Ayyubi Memorial Urdu,2,8,7,1,4,3,87.5,50
2114,110-PATNA,030246-Govt.girls Higher Secondary School,2,8,3,5,0,3,37.5,0
2115,111-ALLAHABAD/PRAYAGRAJ,210059-Mahanagar Boys Inter College,2,8,5,3,2,3,62.5,25
2116,101-HYDERABAD,470023-P R R Jr. College,3,8,8,0,5,3,100,62.5
2117,107-DELHI,M21662-AYESHA PUBLIC SCHOOL,2,8,0,8,0,0,0,0
2118,121-CHENNAI,190173-Tagore Senior Secondary School,2,8,0,8,0,0,0,0
2119,105-CHANDIGARH,050388-Apex Public School,2,8,6,2,2,4,75,25
2120,121-CHENNAI,190105-Mathagondapalli Model School,2,8,8,0,6,2,100,75
2121,113-BHOPAL,100294-Anupama Higher Secondary School,4,8,0,8,0,0,0,0
2122,105-CHANDIGARH,160093-Sidana International School,2,8,8,0,4,4,100,50
2123,105-CHANDIGARH,160140-Chopra Public School,3,8,8,0,8,0,100,100
2124,109-JAIPUR,170421-Akash Science Academy Sr. Sec. School,2,8,8,0,7,1,100,87.5
2125,120-RANCHI,260025-Ramakrishna Mission English School,2,8,5,3,0,5,62.5,0
2126,114-DEHRADUN,340234-Govt. Inter College,2,8,0,8,0,0,0,0
2127,121-CHENNAI,190170-Vivekananda Vision School,2,8,8,0,6,2,100,75
2128,118-GANDHINAGAR,040050-Kendriya Vidyalaya,4,8,8,0,5,3,100,62.5
2129,111-ALLAHABAD/PRAYAGRAJ,210532-Jawahar Navodaya Vidyalaya,2,8,5,3,0,5,62.5,0
2130,103-KOLKATA,220047-Kendriya Vidyalaya No. 2,2,8,0,8,0,0,0,0
2131,117-BENGALURU,080030-Kendriya Vidalaya,3,8,8,0,2,6,100,25
2132,113-BHOPAL,100173-Adarsh Adivasi High School,2,8,0,8,0,0,0,0
2133,109-JAIPUR,170141-Govt. Sr.sec.school,2,8,7,1,7,0,87.5,87.5
2134,104-GUWAHATI,M14025-Little Flower Higher Secondary,2,8,8,0,8,0,100,100
2135,111-ALLAHABAD/PRAYAGRAJ,210680-Urmil Unique Central Academy,2,8,8,0,8,0,100,100
2136,123-GANGTOK,180018-Govt. Senior Secondary School,3,8,8,0,7,1,100,87.5
2137,119-RAIPUR,290151-Govt. Hr.sec. School,1,7,0,7,0,0,0,0
2138,114-DEHRADUN,210725-J.P. Academy Public School,1,7,7,0,7,0,100,100
2139,114-DEHRADUN,M21642-Meerut Girls Inter College,1,7,0,7,0,0,0,0
2140,102-PUNE,360122-Sri Ma Vidyalaya Patlipada,2,7,7,0,7,0,100,100
2141,114-DEHRADUN,210617-Doon Hills Academy,2,7,6,1,6,0,85.71,85.71
2142,114-DEHRADUN,M21308-Muslima Girls Inter College,3,7,2,5,2,0,28.57,28.57
2143,109-JAIPUR,170150-Govt. Hr. Sec. School,2,7,7,0,4,3,100,57.14
2144,121-CHENNAI,190046-Govt. Girls Hr. Sec. School,2,7,7,0,4,3,100,57.14
2145,114-DEHRADUN,210720-Aarti Memorial Sr.Sec.Public School,3,7,0,7,0,0,0,0
2146,104-GUWAHATI,200026-Marachara Class Xii School,2,7,7,0,4,3,100,57.14
2147,106-KOCHI,090008-Bharata Mata College,3,7,7,0,1,6,100,14.29
2148,121-CHENNAI,310001-Kendriya Vidyalaya,3,7,0,7,0,0,0,0
2149,111-ALLAHABAD/PRAYAGRAJ,210179-Shri Sunil Kumar Shiksha Inter collage,3,7,3,4,0,3,42.86,0
2150,121-CHENNAI,420101-Blossom Public School,2,7,0,7,0,0,0,0
2151,122-DHARAMSALA,060051-J.c.b. Public Sr.sec.publilc School,2,7,0,7,0,0,0,0
2152,114-DEHRADUN,340242-Govt. Inter College,2,7,0,7,0,0,0,0
2153,111-ALLAHABAD/PRAYAGRAJ,M21391-Global Oriental School,2,7,3,4,2,1,42.86,28.57
2154,120-RANCHI,260130-K.n. +2 High School,2,7,0,7,0,0,0,0
2155,111-ALLAHABAD/PRAYAGRAJ,320604-Hq 4 Rapid,1,7,3,4,0,3,42.86,0
2156,114-DEHRADUN,210679-Loyal Public School,3,7,0,7,0,0,0,0
2157,102-PUNE,M38212-Anglo Urdu Boys High School & Jr,2,7,7,0,6,1,100,85.71
2158,107-DELHI,270262-Sarvodaya Bal Vidyalaya,1,7,0,7,0,0,0,0
2159,122-DHARAMSALA,"060050-Jai Him Nav Jyoti Sr. Sec. School,",2,7,7,0,7,0,100,100
2160,114-DEHRADUN,340240-Tibetan Homes School,2,7,0,7,0,0,0,0
2161,120-RANCHI,260148-Govt. High School,2,7,7,0,7,0,100,100
2162,118-GANDHINAGAR,390109-Govt. Sec. & Hr. Sec. School,2,7,7,0,7,0,100,100
2163,121-CHENNAI,190171-Shrine vailankanni Sr. Sec. School,3,7,6,1,6,0,85.71,85.71
2164,113-BHOPAL,100291-Hitkari Hr.sec. School,2,7,0,7,0,0,0,0
2165,120-RANCHI,M26188-HOLY CROSS SCHOOL,2,7,0,7,0,0,0,0
2166,109-JAIPUR,170321-New Adarsh Senior Secondary School,1,7,6,1,1,5,85.71,14.29
2167,107-DELHI,270420-Dhanpatmal Virmani Sr.sec.school,1,7,0,7,0,0,0,0
2168,114-DEHRADUN,210636-S.b.d.m. Intermediate College,3,7,0,7,0,0,0,0
2169,118-GANDHINAGAR,390080-Saurabh English School,2,7,7,0,7,0,100,100
2170,118-GANDHINAGAR,040063-Savvy International School,2,7,7,0,7,0,100,100
2171,115-BHUBANESWAR,150054-Ekalavya Model Residential School,2,7,6,1,4,2,85.71,57.14
2172,103-KOLKATA,180005-Fiveways School,2,7,7,0,4,3,100,57.14
2173,102-PUNE,M36123-St. Ursula High School,2,7,7,0,7,0,100,100
2174,113-BHOPAL,100024-Maharishi Vidya Mandir,1,7,5,2,0,5,71.43,0
2175,111-ALLAHABAD/PRAYAGRAJ,210106-Kids Corner Happy Sr. Sec. School,1,7,1,6,0,1,14.29,0
2176,105-CHANDIGARH,050667-Northern International School,2,7,7,0,3,4,100,42.86
2177,111-ALLAHABAD/PRAYAGRAJ,210032-Kendriya Vidyalaya,2,6,4,2,1,3,66.67,16.67
2178,103-KOLKATA,220015-Marwari Panchayat Charity Trust,1,6,6,0,6,0,100,100
2179,120-RANCHI,260135-+2 High School,2,6,0,6,0,0,0,0
2180,106-KOCHI,M09062-Mit Trust English Medium School,1,6,6,0,3,3,100,50
2181,113-BHOPAL,"100093-Mata Beti Bai Public School,",2,6,0,6,0,0,0,0
2182,102-PUNE,110120-Jawahar Navodaya Vidyalaya,1,6,6,0,4,2,100,66.67
2183,109-JAIPUR,170300-Bhoomija Sr.sec. School,1,6,4,2,0,4,66.67,0
2184,105-CHANDIGARH,050402-New Pragati Senior Secondary School,2,6,6,0,1,5,100,16.67
2185,109-JAIPUR,170049-Mahaveer Vidya Mandir,1,6,6,0,3,3,100,50
2186,117-BENGALURU,080072-BVM GLOBAL SCHOOL BENGALURU,1,6,6,0,6,0,100,100
2187,106-KOCHI,M09061-Noorul Huda Orphanage,1,6,6,0,1,5,100,16.67
2188,114-DEHRADUN,210211-Vanasthali Public Sr.sec. School,1,6,0,6,0,0,0,0
2189,121-CHENNAI,310006-Annai Teresa Govt. Girls Hr. Sec.,1,6,0,6,0,0,0,0
2190,122-DHARAMSALA,060024-Sanjay Gandhi Public Sr.sec School,1,6,0,6,0,0,0,0
2191,105-CHANDIGARH,160076-Jawahar Navodaya Vidyalaya,1,6,4,2,2,2,66.67,33.33
2192,114-DEHRADUN,340223-Govt. Inter College,2,6,0,6,0,0,0,0
2193,109-JAIPUR,170148-Adarsh Gyan Mandir Sr.sec. School,2,6,5,1,3,2,83.33,50
2194,115-BHUBANESWAR,150032-Oriental Public School,2,6,4,2,3,1,66.67,50
2195,104-GUWAHATI,320108-58 GTC,1,6,4,2,3,1,66.67,50
2196,111-ALLAHABAD/PRAYAGRAJ,M21652-Sir Syed Public School,1,6,3,3,2,1,50,33.33
2197,110-PATNA,030028-Kendriya Vidyalaya No.-2,2,6,4,2,0,4,66.67,0
2198,114-DEHRADUN,M38371-Madrasa Mahaboobiya High School,1,6,0,6,0,0,0,0
2199,115-BHUBANESWAR,410114-Ravenshaw Collegiate School,1,6,5,1,4,1,83.33,66.67
2200,109-JAIPUR,M38272-Maulana Abul Kalam Azad Muslim,1,6,4,2,2,2,66.67,33.33
2201,113-BHOPAL,M38256-Madarsa Hazrat Bilal,1,6,5,1,5,0,83.33,83.33
2202,102-PUNE,110149-Army Public School,1,6,6,0,5,1,100,83.33
2203,107-DELHI,270414-Muni International School,1,6,6,0,6,0,100,100
2204,111-ALLAHABAD/PRAYAGRAJ,210013-St. Queen Mary's Public School,2,6,2,4,1,1,33.33,16.67
2205,118-GANDHINAGAR,040104-P. Chandra International School,2,6,6,0,2,4,100,33.33
2206,123-GANGTOK,180014-Govt. Senior Secondary School,1,6,6,0,3,3,100,50
2207,107-DELHI,050611-M D Senior Secondary School,1,6,0,6,0,0,0,0
2208,114-DEHRADUN,340263-Adarsh Hr. Sec. School,1,6,0,6,0,0,0,0
2209,106-KOCHI,M09102-Bappuji English Medium School,2,6,6,0,6,0,100,100
2210,110-PATNA,030011-Jawahar Navodaya Vidyalaya,1,6,5,1,0,5,83.33,0
2211,120-RANCHI,260094-+2 High School,1,6,0,6,0,0,0,0
2212,114-DEHRADUN,M38237-Jamia Farooquia Azizul Uloom,1,6,0,6,0,0,0,0
2213,120-RANCHI,260054-D.a.v. Public School Barkakana,2,6,5,1,0,5,83.33,0
2214,114-DEHRADUN,340123-Govt. Inter College,2,6,0,6,0,0,0,0
2215,109-JAIPUR,170366-Navodaya Bal Senior Sec. School,1,6,6,0,1,5,100,16.67
2216,107-DELHI,210722-Ganga Inter National College,1,6,0,6,0,0,0,0
2217,120-RANCHI,260111-+2 High School,2,6,0,6,0,0,0,0
2218,111-ALLAHABAD/PRAYAGRAJ,210414-Jawahar Navodaya Vidyalaya,1,6,1,5,0,1,16.67,0
2219,107-DELHI,050337-Genius Convent Sr. Sec. School,1,6,0,6,0,0,0,0
2220,114-DEHRADUN,210764-S.K.D Public School,1,6,0,6,0,0,0,0
2221,103-KOLKATA,189001-Regional Centre-Gangtok,1,6,6,0,5,1,100,83.33
2222,102-PUNE,110131-Kendriya Vidyalaya,1,6,6,0,5,1,100,83.33
2223,107-DELHI,210394-Gautam Public Hr.sec.school,1,6,0,6,0,0,0,0
2224,118-GANDHINAGAR,040052-Gangadhara High School,1,6,6,0,6,0,100,100
2225,114-DEHRADUN,340102-Maharishi Vidya Mandir,2,6,0,6,0,0,0,0
2226,107-DELHI,050102-Navyug High School,1,6,6,0,6,0,100,100
2227,111-ALLAHABAD/PRAYAGRAJ,210620-Premchandra Shivdhara Inter College,1,6,6,0,6,0,100,100
2228,105-CHANDIGARH,160092-Doon Valley Cambridge School,1,6,6,0,1,5,100,16.67
2229,121-CHENNAI,190018-Veera Savarkar Netaji Matric.school,2,6,6,0,5,1,100,83.33
2230,111-ALLAHABAD/PRAYAGRAJ,210435-Jawahar Navodaya Vidyalaya,1,6,3,3,2,1,50,33.33
2231,111-ALLAHABAD/PRAYAGRAJ,M21544-Al Jamiatul Islamia Khairul Uloom,1,6,6,0,6,0,100,100
2232,105-CHANDIGARH,050609-Aravali Modern School,1,6,6,0,0,6,100,0
2233,114-DEHRADUN,340231-Govt. Intermediate College,1,6,0,6,0,0,0,0
2234,115-BHUBANESWAR,410006-Govt. Higher Secondary School,1,6,5,1,3,2,83.33,50
2235,116-VISAKHAPATNAM,470221-Silver Oaks High School,2,6,5,1,5,0,83.33,83.33
2236,104-GUWAHATI,140028-Govt. Higher Secondary School,1,6,5,1,4,1,83.33,66.67
2237,107-DELHI,M27476-Shiv Modern Senior Secondary School,1,6,0,6,0,0,0,0
2238,114-DEHRADUN,M21661-Delhi Public Global School,2,6,0,6,0,0,0,0
2239,104-GUWAHATI,020052-Jawahar Navodaya Vidyalaya,1,6,6,0,5,1,100,83.33
2240,111-ALLAHABAD/PRAYAGRAJ,210330-Kanpur Public School,1,6,5,1,4,1,83.33,66.67
2241,121-CHENNAI,320412-The Madras Regimental Centre,2,6,0,6,0,0,0,0
2242,120-RANCHI,260172-K.b.s.s.+2 High School,1,6,0,6,0,0,0,0
2243,107-DELHI,050411-Universal Senior Secondary School,2,6,0,6,0,0,0,0
2244,109-JAIPUR,170099-Kendriya Vidyalaya,1,6,6,0,2,4,100,33.33
2245,105-CHANDIGARH,050237-Vivekanand Sr. Sec. School,1,6,6,0,3,3,100,50
2246,120-RANCHI,260085-Jawahar Navodaya Vidyalaya,1,6,0,6,0,0,0,0
2247,122-DHARAMSALA,060012-Govt. Sr. Sec. School,1,6,0,6,0,0,0,0
2248,114-DEHRADUN,340213-Govt. Inter College,2,6,6,0,6,0,100,100
2249,123-GANGTOK,180008-Govt. Senior Secondary School,1,6,6,0,4,2,100,66.67
2250,103-KOLKATA,230006-Govt. Girls Sr. Sec School,1,6,0,6,0,0,0,0
2251,105-CHANDIGARH,160134-Guru Nanak Public School,1,6,6,0,4,2,100,66.67
2252,121-CHENNAI,190054-Govt. Higher Secondary School,1,6,6,0,6,0,100,100
2253,104-GUWAHATI,440003-Orang Higher Secondary School,1,6,4,2,4,0,66.67,66.67
2254,104-GUWAHATI,020019-Little Flower School,2,6,6,0,2,4,100,33.33
2255,120-RANCHI,260195-Name 5141,1,6,0,6,0,0,0,0
2256,104-GUWAHATI,240030-Govt. Higher Secondary School,1,6,6,0,4,2,100,66.67
2257,125-JAMMU,070038-Jawahar Navodaya Vidyalaya,2,6,2,4,0,2,33.33,0
2258,111-ALLAHABAD/PRAYAGRAJ,M21493-Madarsa Muskan,1,6,3,3,1,2,50,16.67
2259,120-RANCHI,260102-Smt. Anarkali +2 School,1,6,0,6,0,0,0,0
2260,111-ALLAHABAD/PRAYAGRAJ,210760-Pt. Gupt Ram Pandey Adarsh Inter College,2,6,4,2,2,2,66.67,33.33
2261,107-DELHI,"G27048-Govt Sarvodaya Kanya Vidalaya, H Block , Phase -1 Ashok Vihar, North West B Delhi-110052",2,6,0,6,0,0,0,0
2262,118-GANDHINAGAR,040062-M.B. Patel Gyanjot Vidhya Vihar,1,6,6,0,5,1,100,83.33
2263,114-DEHRADUN,340318-Doon Bhawani International School,1,6,0,6,0,0,0,0
2264,115-BHUBANESWAR,150187-Brajendra High School,1,6,3,3,3,0,50,50
2265,103-KOLKATA,M22073-St. Thomas High School,2,6,1,5,1,0,16.67,16.67
2266,116-VISAKHAPATNAM,010150-Sri Pragyna Junior College,1,6,6,0,6,0,100,100
2267,104-GUWAHATI,020066-Name 5178,2,6,6,0,3,3,100,50
2268,121-CHENNAI,310011-Navalar Nedunchezhian Govt.Hr.Sec.School,1,6,0,6,0,0,0,0
2269,110-PATNA,030327-Rajkiya Girls +2 High School,1,6,3,3,0,3,50,0
2270,102-PUNE,M11089-N.t.c.c High School,1,5,5,0,5,0,100,100
2271,105-CHANDIGARH,050581-MAA BHAGWATI NIKETAN PUBLIC SCHOOL,1,5,5,0,1,4,100,20
2272,105-CHANDIGARH,050489-Pushpa Kanya Sr. Secondary School,1,5,5,0,4,1,100,80
2273,116-VISAKHAPATNAM,010209-HEAL SCHOOL,1,5,5,0,4,1,100,80
2274,113-BHOPAL,100166-Ram Sundar Higher Secondary School,1,5,0,5,0,0,0,0
2275,122-DHARAMSALA,060010-Govt. Sr. Sec. School,1,5,0,5,0,0,0,0
2276,103-KOLKATA,220101-Kendriya Vidyalaya,1,5,4,1,4,0,80,80
2277,109-JAIPUR,170136-Lady Anusuya Singhania Educational,1,5,5,0,3,2,100,60
2278,111-ALLAHABAD/PRAYAGRAJ,210717-Radhika Senior Secondary School,1,5,2,3,2,0,40,40
2279,117-BENGALURU,V08001-Arundhati Gurukulam,1,5,5,0,5,0,100,100
2280,111-ALLAHABAD/PRAYAGRAJ,M38179-Saint Kabir Inter College,1,5,5,0,5,0,100,100
2281,114-DEHRADUN,340112-Govt. Inter College,1,5,0,5,0,0,0,0
2282,120-RANCHI,260193-Saraswati Shishu Vidya Mandir,1,5,0,5,0,0,0,0
2283,113-BHOPAL,100311-Noble Public School,1,5,5,0,3,2,100,60
2284,111-ALLAHABAD/PRAYAGRAJ,210793-Pahalwan Gurudeen Public School,1,5,5,0,1,4,100,20
2285,113-BHOPAL,"100060-Vidya Bharti Higher Sec School,",1,5,0,5,0,0,0,0
2286,111-ALLAHABAD/PRAYAGRAJ,210582-Raj Devi Ram Karan Public School,1,5,1,4,0,1,20,0
2287,102-PUNE,110075-Shri Bhavani Vidyamandir,1,5,5,0,5,0,100,100
2288,111-ALLAHABAD/PRAYAGRAJ,210751-Green Field Aademy,1,5,1,4,1,0,20,20
2289,104-GUWAHATI,020030-Kendriya Vidyalaya,1,5,5,0,2,3,100,40
2290,105-CHANDIGARH,050027-St. Theresa's Convent School,2,5,3,2,3,0,60,60
2291,104-GUWAHATI,020079-L.N. Bezbarua High School,1,5,5,0,3,2,100,60
2292,113-BHOPAL,100142-Jawahar Navodaya Vidyalaya,1,5,0,5,0,0,0,0
2293,104-GUWAHATI,140018-Neingulie Memorial High School,1,5,5,0,1,4,100,20
2294,121-CHENNAI,190087-Kendriya Vidyalaya,1,5,0,5,0,0,0,0
2295,107-DELHI,210746-Sidhi Vinayak Public School,1,5,0,5,0,0,0,0
2296,111-ALLAHABAD/PRAYAGRAJ,M21660-AL HAFEEZ EDUCATIONAL ACADEMY,1,5,3,2,2,1,60,40
2297,116-VISAKHAPATNAM,010144-Sri Harsha's Junior  & Degree,1,5,5,0,5,0,100,100
2298,105-CHANDIGARH,050625-St. Simran Public School,1,5,5,0,4,1,100,80
2299,113-BHOPAL,100092-Baba Nepali Higher Secondary School,1,5,0,5,0,0,0,0
2300,109-JAIPUR,170355-Hukumchand Public School,1,5,3,2,1,2,60,20
2301,118-GANDHINAGAR,390125-Radhe International School,1,5,5,0,4,1,100,80
2302,122-DHARAMSALA,060063-Shivalik Public Sr.sec.school,1,5,0,5,0,0,0,0
2303,102-PUNE,360109-Bharti Sanskrit Vidya Niketaram,1,5,5,0,5,0,100,100
2304,125-JAMMU,070033-Jawahar Navodaya Vidyalaya,1,5,0,5,0,0,0,0
2305,105-CHANDIGARH,050598-Rajwanshi Shiksha Niketan Sr. Sec. School,1,5,5,0,2,3,100,40
2306,109-JAIPUR,M38315-Khawaja Model School,1,5,0,5,0,0,0,0
2307,104-GUWAHATI,120058-Christian Model English Higher Secondary School,1,5,5,0,4,1,100,80
2308,113-BHOPAL,100198-Jawahar Navodaya Vidyalaya,1,5,0,5,0,0,0,0
2309,121-CHENNAI,M19106-PERAL MATRICULATION SCHOOL,1,5,0,5,0,0,0,0
2310,109-JAIPUR,170327-Manju Public Sr. Secondary School,1,5,5,0,2,3,100,40
2311,113-BHOPAL,100137-Jawahar Navodaya Vidyalaya,1,5,0,5,0,0,0,0
2312,110-PATNA,030260-J.n.k.t.inter School,1,5,3,2,0,3,60,0
2313,121-CHENNAI,420104-BVM GLOBAL BOLLINENI HILLSIDE SENIOR SECONDARY SCHOOL,1,5,5,0,0,5,100,0
2314,103-KOLKATA,230002-Govt. Senior Secondary School,1,5,0,5,0,0,0,0
2315,105-CHANDIGARH,160126-R.P. International Sr.Sec. School,1,5,4,1,1,3,80,20
2316,119-RAIPUR,290140-Govt. Boys Higher Secondary School,1,5,0,5,0,0,0,0
2317,120-RANCHI,260116-Sarvodaya +2 High School,1,5,0,5,0,0,0,0
2318,113-BHOPAL,100086-Vishwa Bharti Higher Sec. School,1,5,0,5,0,0,0,0
2319,103-KOLKATA,220064-B.d.memorial English High School,1,5,0,5,0,0,0,0
2320,111-ALLAHABAD/PRAYAGRAJ,210421-Vansha Devi Inter College,1,5,5,0,0,5,100,0
2321,105-CHANDIGARH,050119-Swami Vivekanand Modern School,1,5,5,0,3,2,100,60
2322,109-JAIPUR,170110-Kamalnishtha Vidya Niketan,1,5,5,0,2,3,100,40
2323,105-CHANDIGARH,050560-Deewal Interrnational School,1,5,5,0,3,2,100,60
2324,106-KOCHI,M09086-Aes Public School,1,5,5,0,2,3,100,40
2325,105-CHANDIGARH,050514-Satluj Senior Secondary School,1,5,5,0,4,1,100,80
2326,104-GUWAHATI,M02066-CENTRAL PUBLIC SCHOOL,1,5,4,1,3,1,80,60
2327,120-RANCHI,260096-Zila School,1,5,0,5,0,0,0,0
2328,107-DELHI,270482-James Convent School,1,5,0,5,0,0,0,0
2329,110-PATNA,030093-Satyendra Narayan Mahila Maha-,1,5,5,0,1,4,100,20
2330,105-CHANDIGARH,160075-Jawahar Navodaya Vidyalaya,1,5,5,0,4,1,100,80
2331,105-CHANDIGARH,160146-N.R.M. HOLLY HEART CONVENT SCHOOL,1,5,5,0,3,2,100,60
2332,114-DEHRADUN,340314-DR. B.R.A INTER COLLEGE,1,5,0,5,0,0,0,0
2333,114-DEHRADUN,210784-Divine Global Academy,1,5,0,5,0,0,0,0
2334,118-GANDHINAGAR,390160-Sandipani Gurukul Vidhyalay,1,5,5,0,5,0,100,100
2335,105-CHANDIGARH,050430-Global Public School,1,5,5,0,0,5,100,0
2336,102-PUNE,M38267-Fazlani L'academie Globale,1,5,5,0,4,1,100,80
2337,111-ALLAHABAD/PRAYAGRAJ,210147-Saint Vivekanandsr.sec.publicschool,1,5,5,0,5,0,100,100
2338,114-DEHRADUN,M38369-Pragati Senior Secondary School,1,5,0,5,0,0,0,0
2339,121-CHENNAI,420059-Kendriya Vidyalaya,1,5,0,5,0,0,0,0
2340,111-ALLAHABAD/PRAYAGRAJ,210788-Paras Public School,1,5,3,2,2,1,60,40
2341,110-PATNA,450093-J.m.institute Of Speech & Hearing,1,5,5,0,1,4,100,20
2342,115-BHUBANESWAR,410102-Govt. High School,1,5,4,1,3,1,80,60
2343,105-CHANDIGARH,050659-Vidyantriksh Sr. Sec. School,1,5,5,0,2,3,100,40
2344,120-RANCHI,260150-R.k.+2 High School,1,5,5,0,5,0,100,100
2345,110-PATNA,030374-JAWAHAR NAVODAYA VIDYALAYA,1,5,5,0,1,4,100,20
2346,105-CHANDIGARH,050471-S.d.senior Secondary School,1,5,5,0,5,0,100,100
2347,105-CHANDIGARH,M16110-Nightingle Sr.Sec. School,1,5,5,0,3,2,100,60
2348,105-CHANDIGARH,050001-Janta Kalyan Samiti,1,5,5,0,1,4,100,20
2349,109-JAIPUR,170325-Sh. Narayan Sr.sec. School,1,5,5,0,3,2,100,60
2350,117-BENGALURU,080069-Patel Public School,1,5,5,0,4,1,100,80
2351,111-ALLAHABAD/PRAYAGRAJ,210708-GAURI SHANKAR PUBLIC SCHOOL,2,5,4,1,4,0,80,80
2352,121-CHENNAI,190037-Kendriya Vidydalaya,1,5,0,5,0,0,0,0
2353,111-ALLAHABAD/PRAYAGRAJ,210639-Sh. Ramesh Chandra I.c. Sonai,1,5,2,3,0,2,40,0
2354,105-CHANDIGARH,050276-Bal Bharti Adarsh Vidhyalaya,1,5,5,0,0,5,100,0
2355,107-DELHI,J05286-District  Jail,1,5,0,5,0,0,0,0
2356,111-ALLAHABAD/PRAYAGRAJ,M21370-Roshan Higher Secondary School,1,5,3,2,1,2,60,20
2357,105-CHANDIGARH,J16004-Name 4921,2,5,5,0,5,0,100,100
2358,102-PUNE,M11130-Iqra English Medium school,1,5,5,0,5,0,100,100
2359,115-BHUBANESWAR,450114-Social Welfare Agency & Training,1,5,5,0,3,2,100,60
2360,105-CHANDIGARH,050509-Hindu Senior Secondary School,1,5,5,0,3,2,100,60
2361,109-JAIPUR,M17273-Hazrat Omar Bin Kattab Pvt. ITI,1,5,5,0,5,0,100,100
2362,105-CHANDIGARH,T16009-SHAHEED BHAGAT SINGH PVT. ITI,3,5,5,0,5,0,100,100
2363,109-JAIPUR,170336-Parmarth Khetaramji Sr.sec. Scchool,1,5,5,0,2,3,100,40
2364,113-BHOPAL,M10275-Madarsa Talimul Quran,1,5,5,0,0,5,100,0
2365,107-DELHI,270552-St. Francis Convent School,1,5,0,5,0,0,0,0
2366,111-ALLAHABAD/PRAYAGRAJ,210739-Guruteg Bahadur Educational Academy,1,5,2,3,1,1,40,20
2367,125-JAMMU,"320525-Hrdc, Hq",1,5,0,5,0,0,0,0
2368,120-RANCHI,260129-+2 High School,1,5,0,5,0,0,0,0
2369,111-ALLAHABAD/PRAYAGRAJ,210468-Pt. Ram Sahay Sharma Inter College,1,5,2,3,1,1,40,20
2370,103-KOLKATA,220131-Holy Christ Secondary School,1,5,0,5,0,0,0,0
2371,102-PUNE,110132-Sudershan English High School &,1,5,5,0,4,1,100,80
2372,121-CHENNAI,190079-Govt. Hr. Sec. School,1,5,0,5,0,0,0,0
2373,114-DEHRADUN,210675-Dron Public School,1,5,0,5,0,0,0,0
2374,118-GANDHINAGAR,040080-Shree Krishna Secondary Higher Secondary School,1,5,5,0,5,0,100,100
2375,113-BHOPAL,"100077-Scope Public School,",1,5,5,0,0,5,100,0
2376,111-ALLAHABAD/PRAYAGRAJ,210633-Sardar Raj Narayan Yadav Inter,1,5,2,3,0,2,40,0
2377,110-PATNA,"030344-+2 High School,",1,5,1,4,0,1,20,0
2378,111-ALLAHABAD/PRAYAGRAJ,210780-M G International School,1,5,4,1,3,1,80,60
2379,105-CHANDIGARH,160166-Holy Angels Smart School,1,5,5,0,4,1,100,80
2380,110-PATNA,030418-P.K.JHA UCHCHATER MADHYMIK VIDHYALAYA ,1,5,4,1,1,3,80,20
2381,107-DELHI,270424-Pragati Public School,1,5,0,5,0,0,0,0
2382,115-BHUBANESWAR,150139-Govt. (ssd) Girls High School,1,5,3,2,2,1,60,40
2383,104-GUWAHATI,140031-Govt. High School,1,5,5,0,2,3,100,40
2384,107-DELHI,270550-R K Memorial Public School,1,5,0,5,0,0,0,0
2385,109-JAIPUR,170279-Stanford Global Academy,1,5,4,1,2,2,80,40
2386,104-GUWAHATI,"020025-Kendriya Vidyalaya Afs,",1,5,5,0,3,2,100,60
2387,113-BHOPAL,100002-Asha Kala Kendra,1,5,0,5,0,0,0,0
2388,118-GANDHINAGAR,040097-Brahmani Vidhyalay,1,5,5,0,4,1,100,80
2389,103-KOLKATA,220130-Gocharan North Point Institute,1,5,0,5,0,0,0,0
2390,125-JAMMU,070043-Jawahar Navodaya Vidyalaya,1,5,1,4,0,1,20,0
2391,110-PATNA,030008-Jawahar Navodaya Vidyalaya,1,5,2,3,0,2,40,0
2392,110-PATNA,030197-Rajkiyakrit Ucchvidyalaya,1,5,4,1,0,4,80,0
2393,120-RANCHI,260174-Govt. Govind +2 School,1,5,0,5,0,0,0,0
2394,117-BENGALURU,M08020-Excellent English School,1,5,5,0,5,0,100,100
2395,107-DELHI,270349-Govt.sarvodaya Co-ed. Sr.sec.school,1,5,0,5,0,0,0,0
2396,106-KOCHI,400048-Kendriya Vidyalaya,1,5,5,0,0,5,100,0
2397,105-CHANDIGARH,160163-Adarsh Modern High School,1,5,5,0,2,3,100,40
2398,115-BHUBANESWAR,"410035-410035-Govt.(SSD) High School, Dabugam",1,5,3,2,2,1,60,40
2399,102-PUNE,M11128-Al Ameen English High School,1,5,5,0,5,0,100,100
2400,105-CHANDIGARH,050507-Ch. Neki Ram Public School,1,5,4,1,0,4,80,0
2401,107-DELHI,050322-Vidya Niketan Sr.sec. School,1,5,0,5,0,0,0,0
2402,115-BHUBANESWAR,150095-Govt. High School,1,5,4,1,3,1,80,60
2403,105-CHANDIGARH,050200-Evergreen High School,1,5,5,0,0,5,100,0
2404,107-DELHI,050642-B S M High School,1,5,0,5,0,0,0,0
2405,114-DEHRADUN,340274-Baluni Public School,1,5,0,5,0,0,0,0
2406,121-CHENNAI,190060-Govt. Hr. Sec. School,1,5,0,5,0,0,0,0
2407,105-CHANDIGARH,050453-Sarvodaya Sr.sec. School,1,5,5,0,0,5,100,0
2408,118-GANDHINAGAR,040096-Swami Vivekanand Vidhyalaya,1,5,5,0,5,0,100,100
2409,120-RANCHI,260127-Jharia Raj +2 High School,1,5,0,5,0,0,0,0
2410,110-PATNA,"030253-High School,",1,5,2,3,0,2,40,0
2411,121-CHENNAI,420090-The Trinity Academy,1,5,0,5,0,0,0,0
2412,122-DHARAMSALA,060100-Army Public School,1,5,4,1,0,4,80,0
2413,109-JAIPUR,170197-Govt. Senior Secondary School,1,5,2,3,0,2,40,0
2414,106-KOCHI,M09037-Mar Ivonios Bethany School,1,5,5,0,5,0,100,100
2415,107-DELHI,G27007-Sarvodaya Vidyalaya Badarpur Kahadar Delhi-110090,1,5,0,5,0,0,0,0
2416,111-ALLAHABAD/PRAYAGRAJ,210807-Rama Convent Inter College,1,5,2,3,1,1,40,20
2417,110-PATNA,M03378-Khalikum Nisha Sajjad Millat,1,5,5,0,1,4,100,20
2418,105-CHANDIGARH,M16009-Guru Nanak Sr. Sec. School,1,5,5,0,3,2,100,60
2419,110-PATNA,030007-Jawahar Navodaya Vidyalaya,1,5,4,1,0,4,80,0
2420,104-GUWAHATI,020055-Jawahar Navodaya Vidyalaya,1,5,5,0,4,1,100,80
2421,107-DELHI,270488-Lavi Public School,1,5,0,5,0,0,0,0
2422,105-CHANDIGARH,160014-Vivekanand Blessed Sr.sec. School,1,5,5,0,3,2,100,60
2423,122-DHARAMSALA,060042-B.l. Central Public School,1,5,0,5,0,0,0,0
2424,107-DELHI,270523-CIAT Convent School,1,5,0,5,0,0,0,0
2425,105-CHANDIGARH,160091-R.k.public High School,1,5,4,1,1,3,80,20
2426,110-PATNA,030409-Chandrasheel Vidyapeeth,1,5,5,0,1,4,100,20
2427,105-CHANDIGARH,050422-Shivaniaa Public School,1,5,5,0,4,1,100,80
2428,114-DEHRADUN,340322-New Oxford Higher Secondary School,1,5,5,0,5,0,100,100
2429,114-DEHRADUN,320315-The Kumaon Regt Centre,1,5,0,5,0,0,0,0
2430,104-GUWAHATI,020035-Kendriya Vidyalaya,2,5,5,0,3,2,100,60
2431,105-CHANDIGARH,050051-Shiv Shakti Sr. Sec. School,1,5,5,0,3,2,100,60
2432,120-RANCHI,260141-R.n.r. +2 High School,1,5,0,5,0,0,0,0
2433,120-RANCHI,M26187-Shine Valley School,1,5,0,5,0,0,0,0
2434,110-PATNA,030367-Jawahar Navodaya Vidyalaya,1,5,5,0,1,4,100,20
2435,121-CHENNAI,190059-Govt. Hr. Sec. School,1,5,0,5,0,0,0,0
2436,125-JAMMU,070017-Girls Higher Sec. School,2,5,3,2,2,1,60,40
2437,107-DELHI,210762-HINDON PUBLIC SCHOOL,2,5,0,5,0,0,0,0
2438,110-PATNA,030062-Adarsh High School,1,5,5,0,0,5,100,0
2439,105-CHANDIGARH,050140-Happy Sr. Sec. School,1,5,5,0,3,2,100,60
2440,114-DEHRADUN,340196-Govt. Inter College,1,5,0,5,0,0,0,0
2441,111-ALLAHABAD/PRAYAGRAJ,210681-Pd. Raj Nayan Intermediate College,1,5,1,4,1,0,20,20
2442,105-CHANDIGARH,050330-Baba Balak Nath Sr.sec. School,1,5,5,0,0,5,100,0
2443,119-RAIPUR,290088-Govt. Boys Higher Secondary School,1,5,0,5,0,0,0,0
2444,121-CHENNAI,190074-Govt. Hr. Sec. School,1,5,5,0,1,4,100,20
2445,111-ALLAHABAD/PRAYAGRAJ,M21503-Safa Shariat College,1,5,3,2,2,1,60,40
2446,105-CHANDIGARH,050521-Model Sanskriti Sr.Sec. School,1,5,5,0,3,2,100,60
2447,107-DELHI,050084-D.s. Arya High School,1,5,3,2,3,0,60,60
2448,113-BHOPAL,"100074-Vivekanand Public Hr.sec. School,",1,5,0,5,0,0,0,0
2449,115-BHUBANESWAR,410002-Daniel Public School,1,5,4,1,3,1,80,60
2450,109-JAIPUR,M17269-Raza Public Sr.sec. School,1,5,3,2,2,1,60,40
2451,114-DEHRADUN,220127-Pearl Rosary School (New),1,5,5,0,4,1,100,80
2452,105-CHANDIGARH,050652-Janta Shiksha Sadan,1,5,5,0,3,2,100,60
2453,110-PATNA,030075-M.g.smarak Ucch Vidyalaya,1,5,5,0,0,5,100,0
2454,111-ALLAHABAD/PRAYAGRAJ,210529-Indresh Verma Vidyapeeth Balika,1,5,4,1,0,4,80,0
2455,104-GUWAHATI,140026-Govt. High School,1,5,5,0,2,3,100,40
2456,118-GANDHINAGAR,M04023-Peer Haji Alisha Bukhari High,1,5,5,0,5,0,100,100
2457,110-PATNA,030366-Dr. Shaligram Mishra College,1,5,2,3,0,2,40,0
2458,119-RAIPUR,290168-Dr. Padumal Punnalal Buxi Model,1,5,0,5,0,0,0,0
2459,105-CHANDIGARH,050138-Shastri High School,1,5,5,0,0,5,100,0
2460,113-BHOPAL,320413-21 Corps Hrdc,1,5,4,1,0,4,80,0
2461,117-BENGALURU,M08056-St. Francis School,1,5,5,0,5,0,100,100
2462,102-PUNE,110122-Jawahar Navodaya Vidyalaya,1,5,4,1,4,0,80,80
2463,107-DELHI,210345-Chodhary Charan Singh Memorial Sr,1,5,0,5,0,0,0,0
2464,104-GUWAHATI,200035-Name 4401,1,5,5,0,3,2,100,60
2465,119-RAIPUR,290084-Jawahar Navodaya Vidyalaya,1,5,0,5,0,0,0,0
2466,111-ALLAHABAD/PRAYAGRAJ,210796-Narayan College of Science and Arts,1,5,2,3,1,1,40,20
2467,110-PATNA,M03358-Madarsa Ahmdia Hanfia,1,5,5,0,1,4,100,20
2468,107-DELHI,270117-Shaheed Hemu Kalani Govt. Sarvodaya,1,5,0,5,0,0,0,0
2469,101-HYDERABAD,470187-Kendriya Vidyalaya,1,5,5,0,5,0,100,100
2470,122-DHARAMSALA,060034-Govt. Senior Secondary School,1,5,0,5,0,0,0,0
2471,110-PATNA,030399-New Horizon School,1,5,3,2,0,3,60,0
2472,121-CHENNAI,190073-Govt. Girls Hr.sec. School,1,5,0,5,0,0,0,0
2473,107-DELHI,270418-Mother Khazani Convent School,1,5,0,5,0,0,0,0
2474,105-CHANDIGARH,050494-Sh. Lal Bahadur Shastri High School,1,5,5,0,0,5,100,0
2475,104-GUWAHATI,020033-Kendriya Vidyalya,1,5,5,0,3,2,100,60
2476,118-GANDHINAGAR,040132-Sandipani Gurukul Vidhyalay,1,5,5,0,3,2,100,60
2477,116-VISAKHAPATNAM,370089-Vignan Talent School,1,5,5,0,2,3,100,40
2478,120-RANCHI,260137-Sant Tulsidas +2 High School,1,5,0,5,0,0,0,0
2479,115-BHUBANESWAR,150049-Govt. Girls High School,1,5,4,1,3,1,80,60
2480,107-DELHI,050622-Universal Public School,1,5,0,5,0,0,0,0
2481,117-BENGALURU,"V08004-Shubham Karoti, Maitreyee Gurukula",1,5,5,0,0,5,100,0
2482,119-RAIPUR,290165-Saraswati Vihar English Medium,1,5,0,5,0,0,0,0
2483,121-CHENNAI,190097-Suddananda Vidyalaya,1,5,5,0,0,5,100,0
2484,111-ALLAHABAD/PRAYAGRAJ,M38184-Amiraddaula Islamia Inter College,1,5,5,0,1,4,100,20
2485,113-BHOPAL,100098-Ekta High School,1,5,0,5,0,0,0,0
2486,111-ALLAHABAD/PRAYAGRAJ,210431-Jawahar Navodaya Vidyalaya,1,5,3,2,1,2,60,20
2487,121-CHENNAI,420079-Helikx Special Learning School,1,5,0,5,0,0,0,0
2488,107-DELHI,270276-Convent Of Gagan Bhatri Sr.s.school,1,5,0,5,0,0,0,0
2489,120-RANCHI,260194-MOTHER'S INTERNATIONAL ACADEMY,1,5,0,5,0,0,0,0
2490,102-PUNE,110121-Jawahar Navodaya Vidyalaya,1,5,5,0,4,1,100,80
2491,109-JAIPUR,170182-Prince International School,1,5,1,4,0,1,20,0
2492,110-PATNA,M03233-Millat Academy Station Road,1,5,4,1,1,3,80,20
2493,119-RAIPUR,T29001-Jagrani Devi ITI,1,5,0,5,0,0,0,0
2494,125-JAMMU,070036-Jawahar Navodaya Vidyalaya,1,5,0,5,0,0,0,0
2495,113-BHOPAL,100068-Mahavir Singh Higher Sec. School,1,5,3,2,3,0,60,60
2496,122-DHARAMSALA,060033-Govt. Senior Secondary School,2,5,0,5,0,0,0,0
2497,111-ALLAHABAD/PRAYAGRAJ,210594-Maa Tripur Sundari Public School,1,5,2,3,0,2,40,0
2498,114-DEHRADUN,340226-Govt. Inter College,2,5,5,0,4,1,100,80
2499,118-GANDHINAGAR,040061-Laxmi International School,1,4,4,0,4,0,100,100
2500,102-PUNE,"110041-Halqua E-dawanik Jr.college,",1,4,4,0,4,0,100,100
2501,115-BHUBANESWAR,150186-Chirstian High School,1,4,1,3,0,1,25,0
2502,104-GUWAHATI,440001-Diphu Commerce Junior College,1,4,4,0,3,1,100,75
2503,119-RAIPUR,M29158-Oriental Public School,1,4,0,4,0,0,0,0
2504,101-HYDERABAD,470158-Jawahar Navodaya Vidyalaya,1,4,4,0,1,3,100,25
2505,115-BHUBANESWAR,150176-Police High School,1,4,3,1,3,0,75,75
2506,105-CHANDIGARH,050483-Paramount Senior Secondary School,1,4,4,0,0,4,100,0
2507,121-CHENNAI,"420106-The Pupil Saveetha Eco. School,",1,4,4,0,0,4,100,0
2508,108-ABROAD/NIOS HQ,980003-Indian School,1,4,0,4,0,0,0,0
2509,118-GANDHINAGAR,040042-Kendriya Vidyalaya,1,4,4,0,2,2,100,50
2510,105-CHANDIGARH,050661-Sarvodaya Public School,1,4,4,0,3,1,100,75
2511,120-RANCHI,260164-Govt. +2 High School,1,4,0,4,0,0,0,0
2512,107-DELHI,050665-NVN School,1,4,0,4,0,0,0,0
2513,105-CHANDIGARH,160050-Star Plus Convent School,1,4,4,0,2,2,100,50
2514,117-BENGALURU,M48002-Delhi Public School,2,4,4,0,3,1,100,75
2515,118-GANDHINAGAR,040084-Govt. Khetivadi Sec. & High sec. School,1,4,4,0,1,3,100,25
2516,119-RAIPUR,290174-Vindhya Public School,1,4,0,4,0,0,0,0
2517,107-DELHI,T27001-Baba Saheb Ambedkar Industrial Training Centre,2,4,0,4,0,0,0,0
2518,120-RANCHI,260154-R.k.+2 High School,1,4,0,4,0,0,0,0
2519,103-KOLKATA,220110-Kendriya Vidyalaya,1,4,0,4,0,0,0,0
2520,117-BENGALURU,480001-Don Bosco Academy,1,4,4,0,2,2,100,50
2521,105-CHANDIGARH,050539-Shaheed Udham Singh Sr. Sec. School,1,4,4,0,2,2,100,50
2522,105-CHANDIGARH,050010-D C Model High School,1,4,4,0,0,4,100,0
2523,107-DELHI,270294-Tagore School,1,4,0,4,0,0,0,0
2524,105-CHANDIGARH,050152-Sarvodaya Shiksha Sadan,1,4,4,0,2,2,100,50
2525,116-VISAKHAPATNAM,010067-S S Jr.college & Sidhartha H.school,1,4,4,0,4,0,100,100
2526,120-RANCHI,260113-+2 Hari High School,1,4,4,0,4,0,100,100
2527,113-BHOPAL,100083-Care English Hr.sec.school,1,4,4,0,0,4,100,0
2528,101-HYDERABAD,M01199-St. Andrews High School,1,4,0,4,0,0,0,0
2529,117-BENGALURU,M08036-Al Nisa Women's Pre University,1,4,4,0,4,0,100,100
2530,105-CHANDIGARH,050293-B.r.m.sr.sec. School,1,4,4,0,0,4,100,0
2531,109-JAIPUR,M17275-MEWAT ACADEMY OF SCHOOL EDUCATION,1,4,4,0,2,2,100,50
2532,109-JAIPUR,170146-Suraj Public School,1,4,3,1,2,1,75,50
2533,113-BHOPAL,100129-Kendriya Vidyalaya,1,4,0,4,0,0,0,0
2534,118-GANDHINAGAR,390099-Jivan Vikas Education Academy,1,4,4,0,4,0,100,100
2535,109-JAIPUR,170369-Noble International School,1,4,3,1,1,2,75,25
2536,119-RAIPUR,290106-Govt. Girls Hr.sec. School,1,4,0,4,0,0,0,0
2537,115-BHUBANESWAR,T41001-Name 5131,2,4,4,0,2,2,100,50
2538,121-CHENNAI,"420058-Kendriya Vidyalaya,",1,4,4,0,0,4,100,0
2539,105-CHANDIGARH,160095-Sidhu Memorial Public School,1,4,4,0,1,3,100,25
2540,105-CHANDIGARH,160168-Meera Medical Institute of Nursing & Hospital,1,4,4,0,3,1,100,75
2541,105-CHANDIGARH,050555-Om Prakash Garg Memorial Public Sch,1,4,4,0,0,4,100,0
2542,105-CHANDIGARH,050590-Saraswati Vidya Mandir Sr. Sec. School,1,4,4,0,3,1,100,75
2543,105-CHANDIGARH,050658-Disha International School,1,4,4,0,3,1,100,75
2544,104-GUWAHATI,"240022-Kendriya Vidyalaya,",1,4,4,0,4,0,100,100
2545,105-CHANDIGARH,050468-Pratap Singh Memorial Sr.sec.school,1,4,4,0,0,4,100,0
2546,121-CHENNAI,190153-Sagar International School,1,4,0,4,0,0,0,0
2547,111-ALLAHABAD/PRAYAGRAJ,"320306-Hrdc, 11 Gorkha Rifles Regimental",1,4,4,0,1,3,100,25
2548,102-PUNE,M38180-Sir Sayyad English High School,1,4,4,0,4,0,100,100
2549,105-CHANDIGARH,050110-Nehru Senior Secondary School,1,4,4,0,0,4,100,0
2550,122-DHARAMSALA,060047-Hill Grove Sr.sec.school,1,4,4,0,4,0,100,100
2551,121-CHENNAI,T19001-Advanced Training Institute,2,4,4,0,3,1,100,75
2552,105-CHANDIGARH,050554-Mother Teresa Modern Public School,1,4,4,0,2,2,100,50
2553,105-CHANDIGARH,T16006-P.S. Technical Institute of,2,4,4,0,4,0,100,100
2554,113-BHOPAL,100188-Shanti Niketan Higher Secondary,1,4,0,4,0,0,0,0
2555,105-CHANDIGARH,160070-Modern Public High School,1,4,4,0,1,3,100,25
2556,121-CHENNAI,190061-Ici Govt. Hr. Sec. School,1,4,0,4,0,0,0,0
2557,121-CHENNAI,420091-Kmc Public Senior Secondary School,1,4,0,4,0,0,0,0
2558,121-CHENNAI,420007-Mahatma Montessori School,3,4,0,4,0,0,0,0
2559,122-DHARAMSALA,060045-St.soldier Convent Sr.sec. School,1,4,0,4,0,0,0,0
2560,125-JAMMU,070021-Unique Public Education Centre,1,4,1,3,0,1,25,0
2561,121-CHENNAI,M19040-Green Valley Matriculation &,1,4,3,1,2,1,75,50
2562,118-GANDHINAGAR,M04034-St.mary's School,1,4,4,0,3,1,100,75
2563,113-BHOPAL,100121-Kendriya Vidyalaya,1,4,0,4,0,0,0,0
2564,102-PUNE,110101-Cges Gulabtola High School&junior,1,4,4,0,4,0,100,100
2565,118-GANDHINAGAR,V04001-Hemachandrachary Sanskrit Pathshala,1,4,4,0,1,3,100,25
2566,107-DELHI,270042-Bal Mandir Public School,1,4,0,4,0,0,0,0
2567,113-BHOPAL,100037-Navambey Convent Hr.sec. School,1,4,0,4,0,0,0,0
2568,109-JAIPUR,170224-Jawahar Navodaya Vidyalaya,1,4,4,0,3,1,100,75
2569,116-VISAKHAPATNAM,010166-Kendriya Vidyalaya,1,4,4,0,4,0,100,100
2570,121-CHENNAI,190149-Avtar Public School,1,4,0,4,0,0,0,0
2571,114-DEHRADUN,M38345-Maa Wahida Begum High School,1,4,0,4,0,0,0,0
2572,111-ALLAHABAD/PRAYAGRAJ,210765-Raksha Devi Inter College,1,4,0,4,0,0,0,0
2573,107-DELHI,270028-Yuva Shakti Model School,1,4,0,4,0,0,0,0
2574,105-CHANDIGARH,050171-Asha High School,1,4,4,0,0,4,100,0
2575,109-JAIPUR,170418-Mata Shravani International School,1,4,4,0,2,2,100,50
2576,109-JAIPUR,170220-Adarsh Naveen Sr. Secondary School,1,4,3,1,2,1,75,50
2577,114-DEHRADUN,210742-H.C.M. Inter College,1,4,0,4,0,0,0,0
2578,122-DHARAMSALA,060093-Ajay Model Sr.sec. School,1,4,0,4,0,0,0,0
2579,117-BENGALURU,080029-Kandriya Vidyalaya,1,4,4,0,2,2,100,50
2580,107-DELHI,380013-Azad Memorial Inter College,1,4,0,4,0,0,0,0
2581,114-DEHRADUN,M34257-Madarsa Ishatul Haq,1,4,0,4,0,0,0,0
2582,122-DHARAMSALA,060011-Govt. Sr.sec. School,1,4,0,4,0,0,0,0
2583,105-CHANDIGARH,160063-A Pee Ji Public Sr.sec.school,1,4,3,1,1,2,75,25
2584,102-PUNE,110042-Holly Cross Boys High School,1,4,4,0,4,0,100,100
2585,107-DELHI,270363-Govt. Sarvodaya Bal Vidyalaya,1,4,0,4,0,0,0,0
2586,110-PATNA,"030356-St.paul Secondary School,",2,4,3,1,1,2,75,25
2587,121-CHENNAI,190053-Govt. High School,1,4,0,4,0,0,0,0
2588,107-DELHI,270456-St. Matthew's Public School,1,4,0,4,0,0,0,0
2589,107-DELHI,050164-Gyandeep Sr.sec School,1,4,0,4,0,0,0,0
2590,114-DEHRADUN,T34005-Vivekanand Mission PVT ITI,2,4,4,0,4,0,100,100
2591,102-PUNE,M36110-Fr. Agnel Multipurpose School,1,4,4,0,4,0,100,100
2592,114-DEHRADUN,340063-Govt. Intermediate College,1,4,0,4,0,0,0,0
2593,108-ABROAD/NIOS HQ,320529-HQ 19 INF Div HRDC,1,4,0,4,0,0,0,0
2594,104-GUWAHATI,200029-Ramnagar Higher Sec. School,1,3,3,0,2,1,100,66.67
2595,120-RANCHI,260098-R.k. +2 High School,1,3,0,3,0,0,0,0
2596,107-DELHI,050557-Karhana Sr.Sec. School,1,3,0,3,0,0,0,0
2597,106-KOCHI,090090-Govt. Hr.sec.school,1,3,3,0,1,2,100,33.33
2598,109-JAIPUR,170175-Govt. Maharawal Sr. Sec. School,3,3,1,2,0,1,33.33,0
2599,109-JAIPUR,170267-Disha Delphi Public School,1,3,3,0,1,2,100,33.33
2600,120-RANCHI,260204-Noamundi Inter College,1,3,0,3,0,0,0,0
2601,107-DELHI,"G27022-GOVT. BOYS SR. SEC. SCHOOL,NEAR UDYOG NAGAR METRO STATION, CAMP NO.-4 JWALAPURI NEW DELHI-87",2,3,1,2,0,1,33.33,0
2602,107-DELHI,M38370-Jesus Grace Modern School,1,3,0,3,0,0,0,0
2603,114-DEHRADUN,340313-Information Technology Institute for the India,1,3,0,3,0,0,0,0
2604,114-DEHRADUN,210782-Guru Govind Singh Public School,1,3,0,3,0,0,0,0
2605,107-DELHI,"G27019-SARVODAYA BAL VIDYALAYA SUBHASH NAGAR MOD, NEAR SUBHASH NAGAR METRO STATION NEW DELHI-110027",3,3,0,3,0,0,0,0
2606,117-BENGALURU,080039-Smt. Shanthabai Edu. Society (R),1,3,3,0,2,1,100,66.67
2607,111-ALLAHABAD/PRAYAGRAJ,210735-R.S. Convent Sainik School,1,3,3,0,1,2,100,33.33
2608,114-DEHRADUN,340261-Govt. Inter College,1,3,0,3,0,0,0,0
2609,109-JAIPUR,170198-Govt. Sr. Sec. School,1,3,3,0,3,0,100,100
2610,116-VISAKHAPATNAM,T01006-BHARAT ITI ,3,3,3,0,3,0,100,100
2611,103-KOLKATA,450180-Voice of World,3,3,3,0,3,0,100,100
2612,111-ALLAHABAD/PRAYAGRAJ,210774-Nirmal Kesia devi Inter College,1,3,3,0,3,0,100,100
2613,109-JAIPUR,170331-Sankalp Academy Sr.sec. School,1,3,3,0,1,2,100,33.33
2614,115-BHUBANESWAR,410142-Government High School,3,3,3,0,3,0,100,100
2615,109-JAIPUR,170449-Dadhimati Vidhya Mandir Sr Sec School,1,3,3,0,1,2,100,33.33
2616,109-JAIPUR,170314-Naveen Sr.sec.school,1,3,1,2,0,1,33.33,0
2617,106-KOCHI,090094-Jr. Baselios English Medium School,2,3,3,0,3,0,100,100
2618,104-GUWAHATI,020031-Kendriya Vidyalaya,1,2,2,0,2,0,100,100
2619,118-GANDHINAGAR,040131-Glorious Public School,1,2,2,0,1,1,100,50
2620,102-PUNE,110138-Kendriya Vidyalaya,1,2,1,1,1,0,50,50
2621,109-JAIPUR,170416-Shree  Kalyan Bal Bharti Sr. Sec. School,1,2,2,0,1,1,100,50
2622,105-CHANDIGARH,M16079-Dashmesh Khals Sr.sec.school,1,2,2,0,1,1,100,50
2623,121-CHENNAI,190144-kids Club Senior Secondary School,1,2,0,2,0,0,0,0
2624,108-ABROAD/NIOS HQ,980004-Bridge Academy,1,2,2,0,2,0,100,100
2625,118-GANDHINAGAR,390089-Shree Swaminarayan Academy,1,2,2,0,2,0,100,100
2626,114-DEHRADUN,T34002-Maharishi Dayanand Pvt. Industrial,1,2,0,2,0,0,0,0
2627,107-DELHI,450151-Manovikas School For Inclusion,1,2,1,1,0,1,50,0
2628,102-PUNE,110137-Kendriya Vidyalaya,1,2,2,0,2,0,100,100
2629,104-GUWAHATI,320118-HQ 44 Mountain Brigade,1,2,2,0,2,0,100,100
2630,121-CHENNAI,190141-Vanshi Manthan Vidyashram,1,2,2,0,0,2,100,0
2631,114-DEHRADUN,T34001-Advanced Training Institute,1,2,0,2,0,0,0,0
2632,105-CHANDIGARH,380276-Kalyan Sr.sec. School,1,2,2,0,1,1,100,50
2633,117-BENGALURU,080054-Shakuntala Patil Residential School,1,2,2,0,0,2,100,0
2634,121-CHENNAI,420060-Kendriya Vidyalaya,1,2,2,0,1,1,100,50
2635,102-PUNE,110117-Jawahar Navodaya Vidyalaya,1,2,2,0,2,0,100,100
2636,111-ALLAHABAD/PRAYAGRAJ,M21444-Eram Intermediate College,2,2,0,2,0,0,0,0
2637,109-JAIPUR,170282-Adinath Senior Sec. Public School,1,2,2,0,2,0,100,100
2638,117-BENGALURU,080070-St. Ann's English School,1,2,2,0,2,0,100,100
2639,119-RAIPUR,290119-Govt. Higher Secondary School,1,2,0,2,0,0,0,0
2640,110-PATNA,"030245-Buxar High School,",2,2,2,0,0,2,100,0
2641,107-DELHI,270527-Ran Singh Model Public School,1,2,0,2,0,0,0,0
2642,118-GANDHINAGAR,040040-K.R. DOSHI  High School,1,2,2,0,1,1,100,50
2643,121-CHENNAI,190176-Prasan Vidya Mandir,1,2,2,0,1,1,100,50
2644,113-BHOPAL,100194-Ma Veena Vadini Higher Sec. School,1,2,0,2,0,0,0,0
2645,115-BHUBANESWAR,"150172-150172-Govt.Boys High School,Unit-9",1,2,2,0,1,1,100,50
2646,107-DELHI,270330-Rishabh Public School,1,2,0,2,0,0,0,0
2647,120-RANCHI,T26009-Gautam Buddha Pvt. ITI,1,2,0,2,0,0,0,0
2648,105-CHANDIGARH,050537-Bhagat Singh Public School,1,2,2,0,0,2,100,0
2649,104-GUWAHATI,240024-Kendriya Vidyalaya,1,2,2,0,2,0,100,100
2650,110-PATNA,030069-Model Inter Vidyalaya,2,2,2,0,0,2,100,0
2651,120-RANCHI,T26005-Gurukul Private ITI,1,2,0,2,0,0,0,0
2652,110-PATNA,M38123-Millat Academy,2,2,0,2,0,0,0,0
2653,103-KOLKATA,"220085-Ramakrishna Mision Ashrama,",1,2,0,2,0,0,0,0
2654,108-ABROAD/NIOS HQ,950021-Agi's Atlas International College,2,2,2,0,2,0,100,100
2655,115-BHUBANESWAR,"410063-Govt. Girls High School,(ssd)",1,2,1,1,1,0,50,50
2656,103-KOLKATA,220030-Nepali Girls Social Service Centre,1,2,2,0,2,0,100,100
2657,120-RANCHI,T26002-Gandhian Institute of Techonology,1,2,1,1,1,0,50,50
2658,107-DELHI,"G27008-GOVT. CO-ED NEW SEELAMPUR GOVT CO-ED M. S. GURUDWARA ROAD, NEW SEELAMPUR-110053",1,2,0,2,0,0,0,0
2659,121-CHENNAI,190077-Govt. Hr. Sec. School,1,2,2,0,2,0,100,100
2660,105-CHANDIGARH,050523-Mahendra Model School,1,2,2,0,2,0,100,100
2661,107-DELHI,"G27064-Govt. Priyadarshini Sarvodaya Kanya Vidyalaya, Fatehpur Beri, South, Delhi-110074",2,2,0,2,0,0,0,0
2662,105-CHANDIGARH,"T16001-Advanced Training Institute,",2,2,2,0,0,2,100,0
2663,117-BENGALURU,080081-Gopalan International School,1,2,2,0,1,1,100,50
2664,111-ALLAHABAD/PRAYAGRAJ,T21006-Gangotri Devi ITI JungleDumary No.1,1,2,1,1,0,1,50,0
2665,105-CHANDIGARH,250011-Sharda Sarvihitakari Model Sr.sec.,1,2,2,0,2,0,100,100
2666,117-BENGALURU,"M08019-St.paul's High School,",1,2,2,0,2,0,100,100
2667,105-CHANDIGARH,T05011-Shree Shyamji Private. ITI,1,2,2,0,2,0,100,100
2668,111-ALLAHABAD/PRAYAGRAJ,T21003-Regional Voc. Training Institute,1,2,1,1,0,1,50,0
2669,113-BHOPAL,100261-Maharana Pratap Higher Sec. School,1,2,0,2,0,0,0,0
2670,111-ALLAHABAD/PRAYAGRAJ,210597-Kendriya Vidyalaya,1,2,1,1,0,1,50,0
2671,111-ALLAHABAD/PRAYAGRAJ,M21295-John Milton Public School,2,2,1,1,0,1,50,0
2672,105-CHANDIGARH,T05006-BMP Private ITI,1,2,2,0,1,1,100,50
2673,107-DELHI,270204-St. Xavier's Sr.sec.school,1,2,0,2,0,0,0,0
2674,105-CHANDIGARH,050550-Navyug Sr.Sec. School,1,2,2,0,1,1,100,50
2675,121-CHENNAI,190163-Maharishi International Residential School,1,2,2,0,1,1,100,50
2676,117-BENGALURU,M08054-Ali Public English Medium High School,1,2,2,0,2,0,100,100
2677,107-DELHI,270485-Kendriya Vidyalaya,1,2,0,2,0,0,0,0
2678,120-RANCHI,260170-R.mitra +2 School,1,2,0,2,0,0,0,0
2679,107-DELHI,"G27037-R.S.K.V. Shankar Nagar, Gandhi Nagar East, Delhi-110031",1,1,0,1,0,0,0,0
2680,100-NOIDA,270226-Sarvodaya Bal Vidyalaya,1,1,0,1,0,0,0,0
2681,115-BHUBANESWAR,150044-Govt. Higher Secondary School,1,1,1,0,1,0,100,100
2682,107-DELHI,270306-Rajender Lakra Model School,1,1,1,0,0,1,100,0
2683,105-CHANDIGARH,160130-Kalgidhar National Sr.Sec.School,1,1,1,0,1,0,100,100
2684,119-RAIPUR,290069-Jawahar Navodaya Vidyalaya,1,1,0,1,0,0,0,0
2685,111-ALLAHABAD/PRAYAGRAJ,210098-Shyam Bihari Singh Inter College,1,1,1,0,0,1,100,0
2686,107-DELHI,270110-D A V Centenary Public School,1,1,0,1,0,0,0,0
2687,122-DHARAMSALA,060029-Govt. Senior Secondary School,1,1,0,1,0,0,0,0
2688,110-PATNA,030384-Don Bosco School,1,1,1,0,0,1,100,0
2689,107-DELHI,"G27032-Govt.Boys Sr.Sec.School Badarpur Near DDA Flats & Post Office, South (East) Delhi-110044",1,1,0,1,0,0,0,0
2690,107-DELHI,270144-Delhi Public School,1,1,0,1,0,0,0,0
2691,121-CHENNAI,190120-Sishya School,1,1,0,1,0,0,0,0
2692,118-GANDHINAGAR,040026-Kendriya Vidyalaya,1,1,1,0,0,1,100,0
2693,107-DELHI,"G27031-Sarvodaya Bal Vidyalaya, Railway Colony Tughlakabad South , New Delhi",1,1,0,1,0,0,0,0
2694,101-HYDERABAD,M38359-Mannu Model School,1,1,1,0,1,0,100,100
2695,114-DEHRADUN,340283-The Oxford School,1,1,0,1,0,0,0,0
2696,120-RANCHI,260131-Govt. +2 High School,1,1,0,1,0,0,0,0
2697,104-GUWAHATI,130021-Nongthymmai Nepali Higher Sec.,1,1,1,0,1,0,100,100
2698,104-GUWAHATI,M02065-CENTRAL PUBLIC SCHOOL,1,1,1,0,1,0,100,100
2699,120-RANCHI,260202-RADHA GOVIND PUBLIC SCHOOL,1,1,1,0,1,0,100,100
2700,101-HYDERABAD,M01198-Insight International School,1,1,1,0,1,0,100,100
2701,119-RAIPUR,290046-Kendriya Vidyalaya,1,1,0,1,0,0,0,0
2702,115-BHUBANESWAR,410086-Govt. High School,1,1,1,0,1,0,100,100
2703,114-DEHRADUN,450107-Deaf & Dumb School,1,1,0,1,0,0,0,0
2704,113-BHOPAL,100191-Narsingh Public Hr. Sec. School,1,1,0,1,0,0,0,0
2705,110-PATNA,030065-Mangal Seminary Inter College,1,1,1,0,0,1,100,0
2706,117-BENGALURU,080068-Jindal Vidya Mandir,1,1,1,0,1,0,100,100
2707,111-ALLAHABAD/PRAYAGRAJ,210699-Karam Devi Memorial Academy,1,1,1,0,1,0,100,100
2708,119-RAIPUR,290105-Govt. Higher Secondary School,1,1,0,1,0,0,0,0
2709,107-DELHI,"G27017-GOVT. BOYS SENIOR SEC. SCHOOL, D-BLOCK, NEAR GURUDWARA, PRASHANT VIHAR, DELHI-85",1,1,0,1,0,0,0,0
2710,111-ALLAHABAD/PRAYAGRAJ,M21578-St. Joseph's Convent School,1,1,1,0,1,0,100,100
2711,121-CHENNAI,420051-Kittappa Mpl. Hr. Sec. School,1,1,0,1,0,0,0,0
2712,107-DELHI,270261-Rajdhani Public School,1,1,0,1,0,0,0,0
2713,110-PATNA,M03400-Angel High School,1,1,1,0,0,1,100,0
2714,125-JAMMU,070063-Army Public School,1,1,1,0,1,0,100,100
2715,120-RANCHI,260128-R.k.+2 School,1,1,0,1,0,0,0,0
2716,104-GUWAHATI,140010-Ibaung Thou Memorial High School,1,1,1,0,0,1,100,0
2717,111-ALLAHABAD/PRAYAGRAJ,210692-Mahatma J.f. Public School,1,1,1,0,0,1,100,0
2718,119-RAIPUR,290028-Maharishi Vidya Mandir-i,1,1,0,1,0,0,0,0
2719,106-KOCHI,M09074-Quadisiyya English Medium Madarsa,1,1,1,0,1,0,100,100
2720,107-DELHI,M38351-Khadijatul Kubra Girls Public Sch.,1,1,1,0,1,0,100,100
2721,105-CHANDIGARH,050384-Apex Public School,1,1,1,0,1,0,100,100
2722,109-JAIPUR,170225-Jawahar Navodaya Vidyalaya,1,1,0,1,0,0,0,0
2723,107-DELHI,270439-Govt. Boys Senior Secondary School,1,1,0,1,0,0,0,0
2724,114-DEHRADUN,340176-Vidya Vikasinee Inter College,1,1,0,1,0,0,0,0
2725,107-DELHI,"G27057-Govt.Girls Sr.Sec.School, No-2 A-Block Janak Puri New West-B, Delhi-110058",1,1,0,1,0,0,0,0
2726,105-CHANDIGARH,050633-Shree Maharaja Aggarsain Public School,1,1,1,0,0,1,100,0
2727,113-BHOPAL,100119-Kendriya Vidyalaya No-1,1,1,0,1,0,0,0,0
2728,111-ALLAHABAD/PRAYAGRAJ,210433-Jawahar Navodaya Vidyalaya,1,1,0,1,0,0,0,0
2729,107-DELHI,270286-Gyan Sagar Public School,1,1,0,1,0,0,0,0
2730,107-DELHI,"G27002-SARVODAYA CO-ED SEC. SCHOOL, I.P. EXT. PATPAR GANJ,DELHI-110092",1,1,0,1,0,0,0,0
2731,120-RANCHI,260004-Sacred Heart Convent School,1,1,1,0,0,1,100,0
2732,110-PATNA,030402-Lohia Nagar Mount Carmel High,1,1,1,0,0,1,100,0
2733,107-DELHI,"G27050-Govt.Girls Sr.School, Bc-Block Sultan Puri, North West, Delhi-110086",1,1,0,1,0,0,0,0
2734,109-JAIPUR,170315-Ajay Shikshan Sansthan Sr.sec.schol,1,1,0,1,0,0,0,0
2735,107-DELHI,270281-Shaheed Bishan S.memo.sr.sec.school,1,1,0,1,0,0,0,0
2736,114-DEHRADUN,210227-H.s.aggarwal Inter College,1,1,0,1,0,0,0,0
2737,107-DELHI,210709-L.K. International School,1,1,1,0,1,0,100,100
2738,105-CHANDIGARH,050087-Arya Sr.sec School,1,1,1,0,1,0,100,100
2739,103-KOLKATA,450043-Raphael Academic & Voc. School,1,1,1,0,0,1,100,0
2740,105-CHANDIGARH,M16097-Holy Mary's School,1,1,1,0,1,0,100,100
2741,119-RAIPUR,290073-Jawahar Navodaya Vidyalaya,1,1,0,1,0,0,0,0
2742,105-CHANDIGARH,250006-Bal Niketan Model Sr.sec.school,1,1,1,0,0,1,100,0
2743,110-PATNA,030390-Jeewan Public School,1,1,1,0,0,1,100,0
2744,121-CHENNAI,190071-Govt. Boys Hr.sec. School,1,1,1,0,1,0,100,100
