SRNO,REGIONAL CENTRE,AI-CODE AND NAME,TOTAL STUDENTS UPLOADED TMA,TOTAL TMA UPLOADED,TOTAL ALLOCATED SUBJECTS,TOTAL UN-ALLOCATED SUBJECTS,TOTAL EVALUATED SUBJECTS,TOTAL ALLOCATED UN-EVALUATED SUBJECTS,PRE-ALLOCATED,PRE-EVALUATED
1,113-BHOPAL,100048-Pragya Higher Secondary School,531,3271,2858,413,115,2743,87.35,3.51
2,118-GANDHINAGAR,M04020-Noori Higher Secondary School - Dhrol,490,2927,2927,0,2270,657,100,77.55
3,118-GANDHINAGAR,"M39049-Noori Higher Secondary School,",496,2921,2921,0,2920,1,100,99.97
4,118-GANDHINAGAR,390102-Navyug Vidyalaya,489,2799,2799,0,2593,206,100,92.64
5,106-KOCHI,M09040-Crescent Rsidential Higher,506,2583,2557,26,170,2387,98.99,6.58
6,109-JAIPUR,170121-Saraswati Vidya Mandir Senior,464,2555,2555,0,2555,0,100,100
7,104-GUWAHATI,240003-Govt.higher Secondary School,404,2412,2399,13,2203,196,99.26,91.15
8,109-JAIPUR,170147-Friends Public Sr.sec. School,421,2273,2264,9,3,2261,99.6,0.13
9,104-GUWAHATI,120018-Royal Academy,422,2232,2224,8,474,1750,99.42,21.19
10,106-KOCHI,M09001-Jdt Islam Orphanage,430,2196,2032,164,489,1543,92.53,22.27
11,109-JAIPUR,170342-Saraswati Adarsh Sr.sec. School,379,2143,0,2143,0,0,0,0
12,104-GUWAHATI,240010-Govt. Higher Sec. School,422,2071,2065,6,1599,466,99.42,76.99
13,104-GUWAHATI,300002-Govt. Bungkawn High School,414,2051,2051,0,1268,783,99.95,61.79
14,104-GUWAHATI,240001-Govt. Hr. Sec. School,390,2042,519,1523,150,369,25.35,7.33
15,118-GANDHINAGAR,"M38147-Noori Higher Secondary School,",426,2039,2039,0,1906,133,100,93.48
16,104-GUWAHATI,200001-Shishu Bihar Higher Sec. School,322,2031,651,1380,117,534,32.04,5.76
17,109-JAIPUR,170132-Hans International Sr.sec.school,353,2031,2026,5,2026,0,99.75,99.75
18,105-CHANDIGARH,250004-D A V Sr.sec. School,376,2006,1969,37,1501,468,98.16,74.83
19,103-KOLKATA,460523-Baidyapara High School,400,1999,1992,7,0,1992,99.6,0
20,103-KOLKATA,460529-Netaji Subhas DAV Public School,355,1974,1974,0,1893,81,100,95.9
21,103-KOLKATA,220119-Netaji Subhas DAV Public School,342,1908,1908,0,1822,86,100,95.49
22,118-GANDHINAGAR,390155-Shree Swaminarayan Gurukul School,296,1834,1834,0,1423,411,100,77.59
23,103-KOLKATA,M22074-Anglo Arabic Secondary School,367,1809,1804,5,1748,56,99.67,96.57
24,104-GUWAHATI,240006-Govt. Hr. Sec. School,333,1786,295,1491,158,137,16.43,8.8
25,104-GUWAHATI,M02073-Lakshirbond Higher Secondary Madarsa,345,1712,1712,0,997,715,100,58.24
26,106-KOCHI,090082-Kendriya Vidyalaya,342,1698,1358,340,145,1213,79.84,8.52
27,104-GUWAHATI,020009-Gohpur Higher Sec. School,349,1691,1683,8,294,1389,99.41,17.37
28,109-JAIPUR,170113-Mahala Residential Public School,265,1667,1562,105,967,595,93.7,58.01
29,109-JAIPUR,170105-Global Career Sr.sec. School,267,1624,0,1624,0,0,0,0
30,118-GANDHINAGAR,380281-Saraswat International Academy,245,1599,1599,0,1596,3,100,99.81
31,114-DEHRADUN,M38300-Makhdoom Baksh Jamia Islamia,241,1558,0,1558,0,0,0,0
32,103-KOLKATA,220099-Jawahar Navodaya Vidyalaya,260,1551,1086,465,204,882,70.02,13.15
33,103-KOLKATA,460510-Dariapur Imampur Barambol High Sch,287,1522,0,1522,0,0,0,0
34,106-KOCHI,090045-Kendriya Vidyalaya,302,1520,1519,1,990,529,99.74,65
35,106-KOCHI,090081-Kendriya Vidyalaya,278,1520,1520,0,1520,0,100,100
36,103-KOLKATA,460528-Gitanjali Public School,254,1435,1435,0,65,1370,100,4.53
37,104-GUWAHATI,240021-Kendriya Vidyalaya,252,1422,1421,1,1406,15,99.93,98.87
38,106-KOCHI,M09006-Ansar English School,277,1409,69,1340,0,69,4.9,0
39,104-GUWAHATI,240017-Govt. Hr.sec.school,230,1405,197,1208,110,87,14.02,7.83
40,103-KOLKATA,220116-Dreamland School,253,1372,1218,154,1218,0,88.78,88.78
41,106-KOCHI,"M09060-M.t.i Central School Pottachira,",263,1365,801,564,0,801,58.68,0
42,107-DELHI,"450061-Akshya Pratisthan,",271,1365,1365,0,1365,0,100,100
43,109-JAIPUR,170031-Rajasthan Public Sr.sec. School,183,1360,1360,0,1360,0,100,100
44,109-JAIPUR,170309-Marwar Winners Public Sr.sec.school,268,1353,0,1353,0,0,0,0
45,106-KOCHI,090064-C.k.m.s.s. Sr. Secondary School,237,1342,1342,0,661,681,100,49.25
46,106-KOCHI,090047-Kendriya Vidyalaya,273,1323,689,634,0,689,52.08,0
47,109-JAIPUR,170365-Shri Imrat Senior Secondary School,268,1320,1301,19,1199,102,98.56,90.83
48,118-GANDHINAGAR,390116-Shree Sharda Secondary & High. Secondary School,266,1320,1320,0,985,335,100,74.62
49,106-KOCHI,090035-Sree Valluvanad Vidya Bhavan,271,1308,1263,45,1263,0,96.56,96.56
50,106-KOCHI,090027-Darussalam Eng. School,259,1294,373,921,0,373,28.8,0
51,118-GANDHINAGAR,390083-Nib School Of Science,222,1277,1274,3,1169,105,99.77,91.54
52,107-DELHI,270433-Chand Ram Public School,262,1277,1262,15,1261,1,98.83,98.75
53,109-JAIPUR,170154-Govt. Sr. Sec. School,233,1271,1270,1,573,697,99.92,45.08
54,109-JAIPUR,170287-Govt. Sr. Sec. School,246,1271,821,450,0,821,64.59,0
55,107-DELHI,270405-ARUN MODERN PUBLIC SR.SEC.SCHOOL,244,1268,1258,10,1234,24,99.21,97.32
56,109-JAIPUR,170374-Saraswti Bal Niketan Sr.Sec. School,276,1221,1208,13,1208,0,98.94,98.94
57,109-JAIPUR,170102-Swami Nityanand Sr.sec.school,243,1216,1216,0,1023,193,100,84.13
58,109-JAIPUR,170444-Shri Ram Sr. Sec. School,288,1211,1207,4,1104,103,99.67,91.16
59,109-JAIPUR,170360-Marudhara Public Sr.Sec. School,255,1200,0,1200,0,0,0,0
60,104-GUWAHATI,140016-Mount Mary Academy,238,1195,1193,2,19,1174,99.83,1.59
61,106-KOCHI,M09071-Islamic Central School,237,1195,104,1091,0,104,8.7,0
62,118-GANDHINAGAR,390100-Sh. Galteshwar Mahadev Hr.Sec.Sch,131,1193,1193,0,1191,2,100,99.83
63,104-GUWAHATI,240019-Kendriya Vidyalaya,230,1190,502,688,468,34,42.18,39.33
64,106-KOCHI,090034-Vyasa Vidya Peethom,220,1184,1179,5,180,999,99.58,15.2
65,107-DELHI,270529-Sant Gyaneshwar Model School,150,1176,0,1176,0,0,0,0
66,106-KOCHI,090058-Kendriya Vidyalaya,227,1174,903,271,431,472,76.85,36.68
67,109-JAIPUR,170191-Bhartiya Vidya Mandir Sr.sec.school,227,1165,7,1158,7,0,0.6,0.6
68,106-KOCHI,090015-Bhavan's Vidya Mandir,259,1155,1017,138,342,675,87.45,29.41
69,118-GANDHINAGAR,390097-Om Shanti English Medium School,190,1142,1142,0,1016,126,100,88.97
70,109-JAIPUR,170051-Bal Vikas Adarsh Sr. Secondary School,243,1133,1133,0,760,373,100,67.08
71,104-GUWAHATI,020044-Kendriya Vidyalaya,257,1119,287,832,36,251,25.65,3.22
72,107-DELHI,"M27191-IASE, FACULTY OF EDUCATION",216,1117,1106,11,816,290,98.93,72.99
73,114-DEHRADUN,M34233-Makhdoom Baksh Jamia Islamia,168,1081,0,1081,0,0,0,0
74,102-PUNE,M38343-Maulana Abul Kalam  Azad Residential Urdu High School & Jr College,195,1080,999,81,220,779,92.5,20.37
75,102-PUNE,280007-Shree Ram High School,150,1072,662,410,0,662,61.75,0
76,106-KOCHI,M09108-Al Ameen English School,159,1071,1071,0,1071,0,100,100
77,104-GUWAHATI,240020-Kendriya Vidyalaya,203,1070,209,861,96,113,19.53,8.97
78,103-KOLKATA,220114-Gitanjali Public School,195,1064,1064,0,16,1048,100,1.5
79,107-DELHI,"270267-Career Public School,473",213,1057,1050,7,107,943,99.34,10.12
80,109-JAIPUR,170446-Seven Star Convent School,209,1050,597,453,3,594,56.86,0.29
81,103-KOLKATA,220037-The Assembly Of God Church School,220,1041,998,43,915,83,95.23,87.31
82,104-GUWAHATI,200020-Hapania High School,162,1048,251,797,44,207,23.95,4.2
83,117-BENGALURU,M38041-Al-ameen Educational Society,242,1038,799,239,3,796,76.9,0.29
84,123-GANGTOK,450178-North Bengal Central School,197,1037,1037,0,935,102,99.9,90.08
85,104-GUWAHATI,020027-Kendriya Vidyalaya,244,1035,869,166,27,842,83.96,2.61
86,118-GANDHINAGAR,040127-Shree Swaminarayan Gurukul School,197,1027,1027,0,994,33,100,96.79
87,106-KOCHI,090048-Kendriya Vidyalaya,193,1003,994,9,509,485,98.91,50.65
88,107-DELHI,270266-M. Savitri D.sanjeevani Pub School,179,999,992,7,823,169,98.8,81.97
89,106-KOCHI,090054-Kendriya Vidyalaya,192,1003,856,147,369,487,85.26,36.75
90,109-JAIPUR,170298-Sunrise Public Sr.sec. School,185,1001,348,653,1,347,34.77,0.1
91,123-GANGTOK,180005-Fiveways School,198,995,995,0,837,158,99.6,83.78
92,107-DELHI,270530-J N International School,192,993,993,0,0,993,99.6,0
93,106-KOCHI,090039-Saraswati Vidya Nikethan Public,203,993,4,989,1,3,0.4,0.1
94,105-CHANDIGARH,050641-Sharde Public School,211,985,985,0,985,0,100,100
95,118-GANDHINAGAR,040068-Om Shanti English Medium School,188,978,978,0,613,365,100,62.68
96,107-DELHI,270489-Satyawati Sood Arya Girls Sr.Sec.,189,972,972,0,0,972,100,0
97,107-DELHI,270137-Dashmesh Public School,180,963,98,865,0,98,10.11,0
98,118-GANDHINAGAR,390095-Ochhavlal Sheth High School,161,962,962,0,816,146,100,84.82
99,109-JAIPUR,170284-Mother Land Shikshan Sansthan,168,956,956,0,848,108,100,88.7
100,104-GUWAHATI,240008-Govt. Hr. Sec. School,187,948,92,856,40,52,9.7,4.22
1,107-DELHI,270226-Sarvodaya Bal Vidyalaya,179,942,1,941,0,1,0.11,0
2,118-GANDHINAGAR,390085-Maruti High School,157,929,929,0,846,83,100,91.07
3,107-DELHI,270542-Angels Public School,169,914,914,0,0,914,100,0
4,106-KOCHI,090012-Travancore Inst.of Sci.& Technology,168,907,878,29,0,878,96.48,0
5,118-GANDHINAGAR,M39051-Razvi High School -  Lalpur,148,907,907,0,904,3,100,99.67
6,114-DEHRADUN,210622-Konark Vidyapeeth,173,901,901,0,827,74,100,91.79
7,117-BENGALURU,M08004-Al-Ameen Educational Society,173,888,869,19,226,643,96.99,25.22
8,118-GANDHINAGAR,390084-B.N. Zala Vidyalaya,147,892,892,0,704,188,100,78.92
9,109-JAIPUR,M17260-St. Francis Sr.Sec. School,171,885,885,0,885,0,100,100
10,109-JAIPUR,M17268-Madarsa Qadariya Faiz E Sikandriya,136,877,872,5,872,0,99.43,99.43
11,118-GANDHINAGAR,390103-D.H.K. Mungra Knaya Vidhyalay,149,873,873,0,686,187,100,78.58
12,118-GANDHINAGAR,390107-Pragati International School,97,872,870,2,866,4,99.77,99.31
13,104-GUWAHATI,140013-H M C High School,179,866,631,235,3,628,72.86,0.35
14,107-DELHI,270454-Gyanodaya Sr. Sec. Public School,162,866,866,0,781,85,100,90.18
15,105-CHANDIGARH,160106-Rajindra Sr.Sec. Public School,145,864,864,0,0,864,100,0
16,118-GANDHINAGAR,M39050-Jamia Ayesha Madarsatul Banat - Dhrol,146,862,862,0,861,1,100,99.88
17,106-KOCHI,090078-Janasakthi Public School,143,859,539,320,0,539,62.67,0
18,107-DELHI,270172-Govt. Boys Sr.secondary School,160,851,830,21,603,227,97.53,70.86
19,107-DELHI,270106-Fr. Agnel School,180,844,837,7,27,810,99.05,3.2
20,104-GUWAHATI,240027-Govt. Secondary School,166,844,835,9,766,69,98.93,90.76
21,114-DEHRADUN,340253-Banjarawala Dehra Public,169,838,81,757,69,12,9.67,8.23
22,118-GANDHINAGAR,390124-S S School of Science,162,831,831,0,748,83,100,90.01
23,109-JAIPUR,170411-Vinayak Vidhya Mandir Sr. Sec. School,166,823,823,0,28,795,100,3.4
24,109-JAIPUR,170332-Shri Krishna Public Sr.sec. School,179,821,725,96,276,449,88.31,33.62
25,105-CHANDIGARH,050607-RISHIKUL SR. SEC. SCHOOL,169,821,121,700,0,121,14.74,0
26,107-DELHI,270459-J.B.M. Public School,163,814,780,34,320,460,95.24,39.07
27,106-KOCHI,"090029-Progressive English School,",167,817,546,271,1,545,66.83,0.12
28,123-GANGTOK,220015-Marwari Panchayat Charity Trust,158,811,723,88,721,2,88.71,88.47
29,107-DELHI,M27477-Victoria Public Sr.sec. School,158,811,729,82,423,306,89.89,52.16
30,115-BHUBANESWAR,"150181-Government High School, koraput",119,807,401,406,256,145,49.69,31.72
31,107-DELHI,050651-S D Public School,175,793,521,272,0,521,65.7,0
32,104-GUWAHATI,300009-Govt. S. Himem High School,182,785,419,366,333,86,53.38,42.42
33,106-KOCHI,090002-M E S Women's College,158,780,764,16,416,348,97.95,53.33
34,107-DELHI,270416-G.d Lancer's Public School,149,773,767,6,767,0,98.84,98.84
35,107-DELHI,M21307-Assisi Convent School,136,775,0,775,0,0,0,0
36,107-DELHI,270406-M.R.L. Senior Secondary School,148,774,634,140,28,606,81.91,3.62
37,106-KOCHI,M09099-Holy Grace Academy,118,765,568,197,0,568,73.86,0
38,118-GANDHINAGAR,040059-B.n. Zala Vidyalaya,148,769,769,0,747,22,100,97.14
39,106-KOCHI,M09059-Markazul Uloom English School,170,763,1,762,0,1,0.13,0
40,118-GANDHINAGAR,390092-Saraswati Vidya Mandir,127,757,757,0,750,7,100,99.08
41,107-DELHI,270318-Saai Memorial Girls School,152,752,701,51,87,614,93.22,11.57
42,109-JAIPUR,170145-Mahima Bal Bharti Sr.sec.school,126,747,747,0,747,0,100,100
43,118-GANDHINAGAR,M04021-Razvi High School - Lalpur,141,744,744,0,739,5,100,99.33
44,107-DELHI,270128-Kendriya Vidyalaya,137,737,721,16,53,668,97.83,7.19
45,109-JAIPUR,170351-Subhash Public Sr.Sec. School,130,733,86,647,70,16,11.73,9.55
46,105-CHANDIGARH,250002-Jan Shiksha Sansthan,141,733,628,105,437,191,85.68,59.62
47,105-CHANDIGARH,"M25012-St. Josephs Sr. Sec. School,",142,732,728,4,282,446,99.45,38.52
48,107-DELHI,270101-ROHTAGI A V SR.SEC.SCHOOL,138,728,717,11,148,569,98.35,20.3
49,104-GUWAHATI,130019-Jawahar Navodaya Vidyalaya,139,727,222,505,35,187,30.49,4.81
50,106-KOCHI,M09091-Aliya Senior Secondary School,135,716,0,716,0,0,0,0
51,104-GUWAHATI,M46002-LAKSHIRBOND HIGHER SECONDARY MADARSSA,155,723,723,0,544,179,100,75.24
52,109-JAIPUR,170341-Ramsnehi Sr.sec. School,120,718,710,8,700,10,98.89,97.49
53,107-DELHI,270472-Kasturba Balika Vidyalaya,144,717,717,0,515,202,100,71.83
54,106-KOCHI,090055-Kendriya Vidyalaya,130,716,0,716,0,0,0,0
55,109-JAIPUR,170445-Choudhary Public Sr. Sec. School,148,716,716,0,714,2,100,99.72
56,109-JAIPUR,170420-Yogyata Vihar Sr. Sec. School,153,715,715,0,714,1,100,99.86
57,106-KOCHI,090053-Vidyadhiraja Vidyapeetom Central,133,713,85,628,0,85,11.9,0
58,115-BHUBANESWAR,454101-SRUSTI (Society For Rural Upliftment & Socio  Technological Initiative),123,711,711,0,652,59,100,91.7
59,103-KOLKATA,460530-Swami Vivekananda Vidyamandir,129,698,687,11,182,505,97.03,25.71
60,107-DELHI,270134-Kautilya Govt Sarvodaya Bal,120,708,0,708,0,0,0,0
61,107-DELHI,270098-Jeewan Jyoti Sr. Sec. School,118,707,707,0,666,41,100,94.2
62,103-KOLKATA,220128-Mount Litera Zee School,127,705,0,705,0,0,0,0
63,104-GUWAHATI,M02074-Gyan Jyoti Higher Secondary School,149,704,704,0,429,275,100,60.94
64,123-GANGTOK,220041-Vidyasagar Higher Secondary School,133,703,475,228,475,0,67.47,67.47
65,105-CHANDIGARH,050533-Vishva Bharti Public School,149,698,38,660,0,38,5.44,0
66,105-CHANDIGARH,050160-Geeta Sr.sec.school,91,696,694,2,379,315,99.71,54.45
67,107-DELHI,270539-M D Indraprastha Public School,140,692,682,10,677,5,98.55,97.83
68,107-DELHI,270483-The Vivekanand School,138,692,681,11,377,304,98.41,54.48
69,106-KOCHI,"090033-Mahatma Gandhi Public School,",93,687,680,7,0,680,98.98,0
70,114-DEHRADUN,340168-Shivedale School,138,681,2,679,0,2,0.29,0
71,107-DELHI,270516-St. Kabir Modern School,131,676,551,125,287,264,81.51,42.46
72,109-JAIPUR,M17215-Maulana Abul Kalam Azad Muslim,135,671,671,0,671,0,100,100
73,107-DELHI,050579-Colonel's Public School,124,671,671,0,124,547,100,18.48
74,109-JAIPUR,170122-Indian Public Sr.Sec.school,139,670,0,670,0,0,0,0
75,109-JAIPUR,170382-Sh. Jagdamba Sr. Sec. School,140,666,0,666,0,0,0,0
76,118-GANDHINAGAR,390098-Shree Taxshila Vidyalaya,86,661,661,0,426,235,100,64.45
77,109-JAIPUR,170283-Bhartiya Shikshan Sansthan Senior,134,660,660,0,441,219,100,66.82
78,106-KOCHI,M09092-Infant Jesus Residential School,129,659,0,659,0,0,0,0
79,105-CHANDIGARH,050569-DELHI VIDYAPEETH ,118,658,0,658,0,0,0,0
80,109-JAIPUR,170343-L.b.s. Adarsh Vidhyalaya,111,658,651,7,643,8,98.94,97.72
81,109-JAIPUR,170364-Lal Bahadur Shastri Sr. Sec. School,107,648,647,1,647,0,99.85,99.85
82,107-DELHI,270224-Cosmos Public School,132,639,494,145,0,494,76.35,0
83,103-KOLKATA,220109-Kendriya Vidyalaya,127,646,0,646,0,0,0,0
84,105-CHANDIGARH,050529-Aastha International Public School,136,644,644,0,632,12,100,98.14
85,107-DELHI,270205-Seth Bhagwandass Sr.sec.school,132,643,0,643,0,0,0,0
86,106-KOCHI,090026-Sree Vivekananda Higher Sec. School,124,641,131,510,2,129,20.44,0.31
87,123-GANGTOK,180003-Govt. Senior Secondary School,136,639,530,109,330,200,82.94,51.64
88,107-DELHI,050621-S R S International School,139,636,543,93,0,543,85.38,0
89,109-JAIPUR,170443-Adarsh Sr. Sec. School,115,635,635,0,499,136,100,78.58
90,107-DELHI,270495-Harcourt Butler Sr. Sec. School,122,633,621,12,618,3,98.1,97.63
91,106-KOCHI,090049-Kendriya Vidyalaya No-2,112,632,546,86,108,438,86.39,17.09
92,105-CHANDIGARH,050311-Suraj Senior Secondary School,120,630,630,0,628,2,100,99.68
93,114-DEHRADUN,210670-Vidya Bhawan Public School,99,629,0,629,0,0,0,0
94,109-JAIPUR,170216-Maa Sharda Sr.sec. Public School,109,626,622,4,622,0,99.36,99.36
95,106-KOCHI,090036-Sree Saraswathy Vidya Mandir,129,623,529,94,363,166,84.64,58.08
96,113-BHOPAL,100206-Amrit  Vidyapeeth School,95,624,624,0,348,276,100,55.77
97,107-DELHI,210198-Bloom Public School,124,624,32,592,1,31,5.13,0.16
98,106-KOCHI,090103-Kendriya Vidyalaya,114,620,614,6,7,607,99.03,1.13
99,106-KOCHI,090097-Naipunnya Public School,129,619,0,619,0,0,0,0
100,106-KOCHI,M09085-Mao Higher Secondary School Elayur,139,618,618,0,618,0,100,100
1,107-DELHI,270115-Govt. Boys Sr. Sec. School No.-1,122,614,0,614,0,0,0,0
2,104-GUWAHATI,140012-St. Joseph's School,119,602,602,0,423,179,99.18,69.69
3,109-JAIPUR,170404-BHAGAT SINGH SR. SEC. SCHOOL,108,607,607,0,0,607,100,0
4,120-RANCHI,260015-Dbms Carrer Academy,88,606,573,33,8,565,94.55,1.32
5,104-GUWAHATI,130012-Douglas Memorial Secondary School,113,605,605,0,7,598,100,1.16
6,105-CHANDIGARH,050429-Modern Senior Secondary School,91,603,67,536,0,67,11.11,0
7,105-CHANDIGARH,050563-AISHLY PUBLIC SCHOOL,127,600,600,0,505,95,100,84.17
8,104-GUWAHATI,200004-R.k. Institution,123,594,117,477,16,101,19.6,2.68
9,123-GANGTOK,220106-Rabindranath Higher Sec. School,107,592,588,4,435,153,99.32,73.48
10,103-KOLKATA,460505-Fulbari High School,104,591,0,591,0,0,0,0
11,114-DEHRADUN,M38342-Jamia Islahul Banaat,86,590,0,590,0,0,0,0
12,107-DELHI,270265-Govt Boys Sr Sec School,101,577,0,577,0,0,0,0
13,103-KOLKATA,M46001-St. Augustine's Day School,123,584,0,584,0,0,0,0
14,107-DELHI,270074-Kendriya Vidyalaya,106,583,579,4,35,544,99.31,6
15,109-JAIPUR,170428-Sainik Children Academy Sr. Sec. School,114,578,101,477,0,101,17.47,0
16,104-GUWAHATI,200024-New Hindi Secondary School,83,577,318,259,39,279,55.11,6.76
17,114-DEHRADUN,210467-Sarvodaya Public School,110,572,393,179,203,190,68.71,35.49
18,104-GUWAHATI,300014-Govt. Leitlangpui Higher Secondary,109,572,562,10,440,122,98.25,76.92
19,107-DELHI,270209-Rajkiya Sarvodaya Bal Vidyalaya No1,116,564,503,61,143,360,88.25,25.09
20,109-JAIPUR,170281-Bharti Bal Niketan Sr.sec. School,113,569,568,1,421,147,99.82,73.99
21,109-JAIPUR,170348-Kamal Vidya Mandir Secondary School,105,568,0,568,0,0,0,0
22,107-DELHI,050262-DELHI PUBLIC SCHOOL,158,561,0,561,0,0,0,0
23,104-GUWAHATI,020075-Rangkut Krorsing High School,129,566,293,273,91,202,51.77,16.08
24,114-DEHRADUN,340162-Queen's Public School,116,565,562,3,181,381,99.47,32.04
25,109-JAIPUR,170127-Rajasthan Public School,113,563,542,21,0,542,96.27,0
26,103-KOLKATA,220054-North Point Sr.sec.boarding School,102,560,443,117,182,261,78.69,32.33
27,106-KOCHI,090038-Vedavyasa Vidyalayam Sr.secondary,105,562,0,562,0,0,0,0
28,114-DEHRADUN,M21543-Jamia Qasmia Darul Uloom,92,557,0,557,0,0,0,0
29,107-DELHI,270317-B.R.TYAGI SR.SEC.SCHOOL,110,557,515,42,515,0,92.46,92.46
30,105-CHANDIGARH,M16056-Guru Nanak Public Sr Sec School,123,556,556,0,452,104,100,81.29
31,104-GUWAHATI,200022-Chailengta H.s.school,88,552,435,117,326,109,78.8,59.06
32,105-CHANDIGARH,M05445-Mewat Adarsh Sr.sec. School,92,550,550,0,167,383,99.82,30.31
33,123-GANGTOK,180002-Namchi Govt.sr.sec. School,111,549,417,132,102,315,75.96,18.58
34,105-CHANDIGARH,050476-Baba Mungipa Sr.sec. School,122,546,534,12,374,160,97.8,68.5
35,106-KOCHI,M09084-Al Irshad Sr.sec. English School,112,542,542,0,1,541,100,0.18
36,107-DELHI,050664-Rao Puran Singh Public School,117,540,531,9,516,15,98.33,95.56
37,103-KOLKATA,220004-Bholananda National Vidyalaya,95,539,493,46,80,413,91.3,14.81
38,107-DELHI,270149-Nav Jeevan Adarsh Pub.sr.sec.school,109,539,0,539,0,0,0,0
39,109-JAIPUR,170053-Nehru Modern Secondary School,114,537,537,0,537,0,100,100
40,104-GUWAHATI,120031-Mount Everest Hr. Sec. School,105,535,184,351,0,184,34.39,0
41,114-DEHRADUN,210799-Gurukul Vidyapeeth,94,535,516,19,516,0,96.45,96.45
42,109-JAIPUR,170347-Adarsh Senior Secondary School,109,528,528,0,528,0,100,100
43,107-DELHI,270367-Govt Boys Sr.sec School,118,525,0,525,0,0,0,0
44,121-CHENNAI,190033-Kendriya Vidyalaya,120,522,167,355,59,108,31.81,11.24
45,123-GANGTOK,220058-Paranami Balika Vidya Mandir,104,520,0,520,0,0,0,0
46,109-JAIPUR,170290-Gyandeep Adarsh Senior Secondary Sc,93,519,519,0,508,11,100,97.88
47,103-KOLKATA,460524-Herobhanga Vidyasagar,99,514,0,514,0,0,0,0
48,120-RANCHI,260184-Saraswati Shishu Vidya Mandir,113,513,340,173,120,220,66.28,23.39
49,107-DELHI,270220-Kendriya Vidyalaya,103,510,0,510,0,0,0,0
50,114-DEHRADUN,340230-Govt. Inter College,99,510,507,3,0,507,99.41,0
51,109-JAIPUR,170269-Choudhary Educational Institute,95,507,507,0,413,94,100,81.46
52,107-DELHI,270484-Nalanda Modern Public School,90,504,501,3,0,501,99.4,0
53,107-DELHI,270415-Doon Public School,94,501,494,7,55,439,98.6,10.98
54,109-JAIPUR,170437-Choudhary Gharsiram Public School,96,500,499,1,499,0,99.8,99.8
55,109-JAIPUR,170393-Pooja International Academy,106,497,494,3,355,139,99.4,71.43
56,104-GUWAHATI,"020022-Don Bosco High School,",108,494,492,2,62,430,98.99,12.47
57,125-JAMMU,070041-Jawahar Navodaya Vidyalaya,115,495,495,0,493,2,100,99.6
58,107-DELHI,270180-Vasant Valley School,107,484,264,220,0,264,53.88,0
59,107-DELHI,270170-Govt. Boys Sr.sec.school,95,489,489,0,489,0,99.8,99.8
60,104-GUWAHATI,M44001-Jaleswar Girls Higher secondary School,120,490,490,0,368,122,100,75.1
61,107-DELHI,270395-Ch. Baldev Singh Model Sec.school,91,488,488,0,194,294,100,39.75
62,109-JAIPUR,170433-Global Public Sr. Sec. School,81,485,485,0,453,32,100,93.4
63,115-BHUBANESWAR,410128-410128-Town High School,77,482,327,155,231,96,67.56,47.73
64,106-KOCHI,090020-T.k.m. Higher Sec. School,95,478,240,238,186,54,50.21,38.91
65,107-DELHI,270521-New Delhi Public School,96,478,466,12,0,466,97.49,0
66,109-JAIPUR,170349-Shri Balaji Public SR.Sec. School,100,476,475,1,259,216,99.79,54.41
67,109-JAIPUR,170328-Shri Adarsh Vidya Mandir Senior,97,476,476,0,476,0,100,100
68,107-DELHI,270462-Adarsh Lakhpat Model Sec. School,71,475,475,0,463,12,100,97.47
69,106-KOCHI,M09107-Irshadiyya Public School,84,473,250,223,0,250,52.74,0
70,105-CHANDIGARH,160038-Shastri Model School,98,468,458,10,429,29,97.86,91.67
71,106-KOCHI,090017-Sreeniketan Centre For Social,81,465,29,436,29,0,6.24,6.24
72,109-JAIPUR,170312-New Bright Land Public Sr.sec.sch.,87,462,413,49,385,28,89.39,83.33
73,104-GUWAHATI,440012-Nabadaya Jatiya Bidyalaya,101,460,206,254,102,104,44.78,22.17
74,121-CHENNAI,M38341-Kh Matriculation Boys Hr.sec.school,109,460,460,0,180,280,100,39.13
75,123-GANGTOK,189001-Regional Centre-Gangtok,110,459,459,0,89,370,100,19.39
76,107-DELHI,M21655-Fr. Agnel School,88,457,448,9,154,294,97.6,33.55
77,103-KOLKATA,220011-St.vincent's High& Technical School,107,458,436,22,0,436,95.2,0
78,109-JAIPUR,170396-Vidya Bharti Sr. Secondary School,76,457,434,23,0,434,94.97,0
79,109-JAIPUR,170337-Hillgrove Col's Academy,89,454,243,211,233,10,53.52,51.32
80,107-DELHI,270249-Psm Senior Secondary School,92,453,174,279,0,174,38.33,0
81,107-DELHI,050373-Jyoti Public Sr.secondary School,97,454,36,418,0,36,7.93,0
82,109-JAIPUR,170250-Swami Vivekanand Sr.sec. School,41,453,0,453,0,0,0,0
83,118-GANDHINAGAR,390101-Shree Matruvandan Secondary & Higher Secondary School,88,450,450,0,388,62,100,86.22
84,117-BENGALURU,080065-Clarence High School,86,444,437,7,382,55,97.33,85.08
85,121-CHENNAI,190005-The C.p.ramaswami Aiyar Foundation,89,434,379,55,366,13,84.79,81.88
86,109-JAIPUR,170326-Pooja Sr.sec. School,89,444,444,0,444,0,100,100
87,107-DELHI,270507-NAV JEEVAN ADARSH PUBLIC SCHOOL,93,443,2,441,0,2,0.45,0
88,109-JAIPUR,170033-Lamoria Girls Sec. School,70,440,440,0,440,0,100,100
89,107-DELHI,270125-Kendriya Vidyalaya,91,440,325,115,0,325,73.86,0
90,107-DELHI,270486-L.K. International School,76,439,436,3,0,436,99.32,0
91,111-ALLAHABAD/PRAYAGRAJ,M21351-A.a.khan Memorial Inter College,87,434,434,0,411,23,100,94.7
92,114-DEHRADUN,210618-B.s.m. School,91,430,314,116,5,309,72.85,1.16
93,106-KOCHI,M09110-Markaz Higher Secondary School for Boys,78,428,428,0,105,323,99.53,24.42
94,107-DELHI,210210-Noida Public Senior Sec.school,88,429,0,429,0,0,0,0
95,117-BENGALURU,080022-Delhi Public School,85,423,422,1,379,43,98.6,88.55
96,109-JAIPUR,170251-National Shikshan Sansthan,90,427,427,0,354,73,100,82.9
97,106-KOCHI,090019-Labour India Public School,94,427,243,184,65,178,56.91,15.22
98,106-KOCHI,M09041-Darul Hikam Residential School,85,426,0,426,0,0,0,0
99,113-BHOPAL,100050-Arjun Higher,82,426,265,161,0,265,62.21,0
100,106-KOCHI,090067-Jawahar Navodaya Vidyalaya,81,422,0,422,0,0,0,0
1,109-JAIPUR,170373-Gyandeep Shikshan Sansthan Senior,52,423,0,423,0,0,0,0
2,107-DELHI,270508-BHARAT MATA SARASWATI BAL MANDIR SCHOOL,82,423,153,270,79,74,36.17,18.68
3,104-GUWAHATI,020070-Nabadaya Jatiya Bidyalaya,92,421,223,198,82,141,52.97,19.48
4,107-DELHI,050258-Bansi Vidya Niketan Sr. Sec. School,82,415,415,0,398,17,99.76,95.67
5,106-KOCHI,090098-B.R. Memorial Central School,69,415,0,415,0,0,0,0
6,107-DELHI,270398-D V Public School,78,414,414,0,88,326,100,21.26
7,103-KOLKATA,M22098-St. Augustines Day School,117,414,125,289,5,120,30.19,1.21
8,107-DELHI,270007-Col.satsangi's Kiran Memo. Aipeccs,89,414,412,2,124,288,99.52,29.95
9,114-DEHRADUN,210736-Vishva Bharti Vidyapeeth,72,409,100,309,0,100,24.45,0
10,118-GANDHINAGAR,390115-Prizam School Of Science,48,409,409,0,378,31,100,92.42
11,107-DELHI,270382-Remal Public School,84,407,406,1,221,185,99.51,54.17
12,104-GUWAHATI,240016-Govt. Higher Secondary School,86,407,68,339,26,42,16.71,6.39
13,107-DELHI,270323-Govt.boys Sr.Sec.School,83,401,394,7,394,0,97.04,97.04
14,105-CHANDIGARH,160061-MOTHER CHHANKAUR CONVENT SCHOOL,74,406,406,0,217,189,100,53.45
15,103-KOLKATA,220107-Malda Railway High School,77,405,0,405,0,0,0,0
16,103-KOLKATA,220076-Vikram Vidyalaya,71,405,0,405,0,0,0,0
17,105-CHANDIGARH,050549-Bal Bharati Internationl Public Sch,66,405,405,0,404,1,100,99.75
18,106-KOCHI,090046-Kendriya Vidyalaya No-2,68,402,0,402,0,0,0,0
19,107-DELHI,210748-Ghaziabad Public School,86,399,0,399,0,0,0,0
20,107-DELHI,270336-Amrita Public School,78,397,0,397,0,0,0,0
21,107-DELHI,050129-Modern Sr. Secondary School,76,396,396,0,396,0,100,100
22,123-GANGTOK,M22096-Scottish Universities Mission,81,395,30,365,0,30,7.59,0
23,102-PUNE,M11112-Anglo Urdu Boys High School & Jr.,96,386,381,5,245,136,96.46,62.03
24,105-CHANDIGARH,450173-Govt. Rehabilitation Inst. For Intellectual Disabilities,75,392,392,0,383,9,99.75,97.46
25,125-JAMMU,070007-Kendriya Vidyalaya Leh,81,392,332,60,0,332,84.69,0
26,107-DELHI,270309-Rahul Model Public School,80,390,0,390,0,0,0,0
27,118-GANDHINAGAR,040071-V.D.T Girls High School,78,388,388,0,286,102,100,73.71
28,103-KOLKATA,220038-Don Bosco School,80,386,317,69,0,317,81.7,0
29,107-DELHI,210215-Green Field Sr.sec.public School,76,387,0,387,0,0,0,0
30,107-DELHI,050261-Drona Public School,80,386,38,348,0,38,9.82,0
31,107-DELHI,270493-Sardar Patel Public Sr. Sec. School,77,386,386,0,373,13,100,96.63
32,103-KOLKATA,460502-Barasija Fulur Anchal Vidyalaya,72,386,0,386,0,0,0,0
33,104-GUWAHATI,130018-Tome Memorial Secondary School,88,385,334,51,152,182,86.75,39.48
34,106-KOCHI,090079-Parama Bhajtara Kendriya Vidyalayam,60,383,0,383,0,0,0,0
35,114-DEHRADUN,210586-Lakshya Public School,48,383,383,0,342,41,100,89.3
36,103-KOLKATA,"220071-Kendriya Vidyalaya No.1, Afs,",83,381,381,0,381,0,99.48,99.48
37,106-KOCHI,090057-Kendriya Vidyalaya,76,381,0,381,0,0,0,0
38,104-GUWAHATI,130027-Jyoti Sroat School,88,380,129,251,11,118,33.95,2.89
39,104-GUWAHATI,020058-Prabhat Tara Children Eng.academy,86,378,376,2,313,63,99.47,82.8
40,105-CHANDIGARH,250010-Shivalik Public School,81,378,0,378,0,0,0,0
41,107-DELHI,270544-R C S Convent School,74,378,371,7,0,371,98.15,0
42,103-KOLKATA,220035-St. Ambrose Vidyalaya,73,377,375,2,340,35,99.47,90.19
43,105-CHANDIGARH,050075-K.c.m Army Sr.sec.school,83,377,374,3,374,0,99.2,99.2
44,114-DEHRADUN,M38199-Madarsa Islamia Talimul Quran,80,376,249,127,159,90,66.22,42.29
45,111-ALLAHABAD/PRAYAGRAJ,210430-Jawahar Navodaya Vidyalaya,76,376,300,76,290,10,79.79,77.13
46,107-DELHI,270344-West Point Model School,64,374,374,0,374,0,100,100
47,103-KOLKATA,220108-Kendriya Vidyalaya,67,372,0,372,0,0,0,0
48,107-DELHI,M27483-Victoria Girls Senior Secondary School,78,370,0,370,0,0,0,0
49,104-GUWAHATI,020013-Doomdooma Junior College,90,369,357,12,180,177,96.75,48.78
50,114-DEHRADUN,M21332-Capital Public School,81,368,368,0,368,0,100,100
51,115-BHUBANESWAR,410150-KALINGA INSTITUTE OF SOCIAL SCIENCES (KISS),75,365,334,31,222,112,91.01,60.49
52,107-DELHI,270431-Holy International Sr. Sec. School,67,366,353,3,353,0,96.45,96.45
53,114-DEHRADUN,210152-Asha Modern School,72,366,0,366,0,0,0,0
54,114-DEHRADUN,M21505-Jamia Tut Tayyibat Niswan College,64,366,366,0,348,18,100,95.08
55,109-JAIPUR,170229-Jawahar Navodaya Vidyalaya,64,366,0,366,0,0,0,0
56,114-DEHRADUN,340208-Government Inter College,60,363,0,363,0,0,0,0
57,107-DELHI,M21663-AYAN NATIONAL PUBLIC SCHOOL,65,363,33,330,0,33,9.09,0
58,105-CHANDIGARH,050577-ASHA DEEP SR. SEC. SCHOOL,67,361,361,0,315,46,100,87.26
59,109-JAIPUR,170329-Pole Star The School,74,361,0,361,0,0,0,0
60,106-KOCHI,090051-Vyas Vidyaniketan Central School,66,358,358,0,356,2,99.44,98.89
61,114-DEHRADUN,210698-Adarsh Shiksha Mandir Inter College,77,360,360,0,360,0,100,100
62,106-KOCHI,090077-Vimala Hridaya Icse School,72,360,220,140,4,216,61.11,1.11
63,104-GUWAHATI,140019-Govt. Hr. Sec. School,70,359,138,221,0,138,38.44,0
64,107-DELHI,210781-Adarsh Gyan Sarovar Public School,75,358,358,0,358,0,100,100
65,118-GANDHINAGAR,390122-Brahmani Vidhyalay,71,357,357,0,349,8,100,97.76
66,109-JAIPUR,170390-Vikram Shikshan Sansthan Sr.Sec.Sch,48,357,353,4,0,353,98.88,0
67,107-DELHI,270346-S.d.m. Model Secondary School,72,356,273,83,143,130,76.69,40.17
68,109-JAIPUR,170271-Shiv Saraswati Sr.sec.vidya Mandir,52,356,347,9,344,3,97.47,96.63
69,105-CHANDIGARH,050576-KOTA PUBLIC SCHOOL,74,354,289,65,185,104,81.64,52.26
70,109-JAIPUR,170123-Shishu Bharti Sr.sec.school,51,354,19,335,1,18,5.37,0.28
71,118-GANDHINAGAR,040043-SUNGRACE VIDHYALAYA,67,350,350,0,258,92,98.87,72.88
72,111-ALLAHABAD/PRAYAGRAJ,"210302-Mahavir Vidya Mandir Inter College,",74,353,353,0,303,50,100,85.84
73,107-DELHI,270426-Pioneer Convent School,71,351,341,10,340,1,97.15,96.87
74,114-DEHRADUN,340133-T.c.g. Public School,73,349,349,0,65,284,100,18.62
75,102-PUNE,110080-Bharat Education Society,71,345,345,0,344,1,99.14,98.85
76,113-BHOPAL,100055-Bharat Mata Hr.sec.school,42,346,317,29,0,317,91.62,0
77,114-DEHRADUN,340222-R.c.d. Public School,74,344,3,341,0,3,0.87,0
78,114-DEHRADUN,340272-Govt. Inter College,70,344,344,0,344,0,100,100
79,109-JAIPUR,170436-Pink Pearl Shikshan Sansthan Sr. Sec. School,64,343,343,0,343,0,100,100
80,104-GUWAHATI,240015-Govt. Higher Secondary School,70,341,103,238,69,34,30.21,20.23
81,121-CHENNAI,190136-The Pupil Saveetha Eco. School,69,336,0,336,0,0,0,0
82,107-DELHI,270509-BHARTI VIDYA NIKETAN PUBLIC SCHOOL,73,339,0,339,0,0,0,0
83,107-DELHI,270502-S.E.S BABA NEBHARAJ SR. SEC. SCHOOL,66,332,300,32,97,203,89.29,28.87
84,105-CHANDIGARH,050631-Sand Grove Sr. Sec. School,76,336,336,0,336,0,100,100
85,103-KOLKATA,460533-Mount Litera Zee School,60,336,0,336,0,0,0,0
86,103-KOLKATA,220008-Salkia Shri Vikram Balika Vidyalaya,65,335,335,0,334,1,100,99.7
87,114-DEHRADUN,340045-St. Joseph's Academy,83,335,321,14,143,178,95.82,42.69
88,103-KOLKATA,220115-Mal Ideal Hindi High School (h.s.),69,334,0,334,0,0,0,0
89,109-JAIPUR,M17272-Khalsa Academy,50,331,0,331,0,0,0,0
90,117-BENGALURU,M08048-Delhi Public School,73,327,2,325,0,2,0.61,0
91,109-JAIPUR,170143-Ideal Public School,68,329,329,0,329,0,100,100
92,107-DELHI,270510-HINDON PUBLIC SCHOOL ,64,329,142,187,0,142,43.16,0
93,121-CHENNAI,190006-Measi Matriculation Hr.sec. School,59,326,25,301,0,25,7.62,0
94,104-GUWAHATI,M02068-AMBARI BAZAR HIGH SCHOOL,75,326,326,0,168,158,100,51.53
95,105-CHANDIGARH,050647-Vikas Sen Sec. School,72,326,0,326,0,0,0,0
96,125-JAMMU,070045-Srinagar Group of Schools,71,325,0,325,0,0,0,0
97,114-DEHRADUN,340199-Govt. Inter College,51,321,321,0,0,321,99.38,0
98,104-GUWAHATI,120061-BISHNULAL GOVERNMENT HIGH SCHOOL,73,322,314,8,278,36,97.52,86.34
99,105-CHANDIGARH,250014-Gyandeep Model Sr.sec. School,68,321,0,321,0,0,0,0
100,105-CHANDIGARH,050369-Pooja Modern Sr. Secondary School,65,319,317,2,317,0,99.37,99.37
1,104-GUWAHATI,130002-Sacred Heart Girls Higher Secondary,59,317,131,186,4,127,41.32,1.26
2,118-GANDHINAGAR,390117-Taxshila Vidyalaya,53,316,316,0,297,19,100,93.99
3,106-KOCHI,090096-Toc H (R) Public School,66,308,0,308,0,0,0,0
4,104-GUWAHATI,120057-Jawahar Navodaya Vidyalaya,65,315,67,248,0,67,21.27,0
5,103-KOLKATA,220070-Bhetaguri Lal Bahadur Shastri Vidyapith,57,314,0,314,0,0,0,0
6,107-DELHI,M38078-Institute of Advanced Studies In Education,61,314,309,5,246,63,98.41,78.34
7,107-DELHI,270203-R.d. Public Sr.sec.school,58,314,158,156,5,153,50.32,1.59
8,103-KOLKATA,220111-KENDRIYA VIDYALAYA IIMC JOKA,66,305,0,305,0,0,0,0
9,105-CHANDIGARH,050534-Yaduvanshi Shiksha Niketan,62,313,313,0,313,0,100,100
10,109-JAIPUR,170302-Vandana Bal Vidya Niketan Senior,55,311,310,1,0,310,99.68,0
11,107-DELHI,270300-Shashi Public Secondary School,61,310,0,310,0,0,0,0
12,109-JAIPUR,170265-M.d.bhati Saraswati Niketan,51,310,310,0,303,7,100,97.74
13,105-CHANDIGARH,160087-Genius Public School,69,310,310,0,285,25,100,91.94
14,107-DELHI,270384-St.marks Sr.secondary Public School,56,310,303,7,159,144,97.74,51.29
15,106-KOCHI,M09042-Mar Dionysius Sr.sec.school,67,309,0,309,0,0,0,0
16,105-CHANDIGARH,050077-Adarsh Sr.sec.school,62,308,308,0,308,0,100,100
17,107-DELHI,270498-Mother Divine Public School,63,308,302,6,298,4,98.05,96.75
18,107-DELHI,M27482-Guru Harkrishan Public School,62,306,253,53,73,180,82.68,23.86
19,107-DELHI,270463-Mata Kasturi Devi Sr.sec.school,54,299,142,157,0,142,46.56,0
20,107-DELHI,270513-Joseph & Mary  Senior Secondary School,49,305,0,305,0,0,0,0
21,104-GUWAHATI,200015-Sabroom Boys Higher Sec. School,59,305,304,1,14,290,99.67,4.59
22,109-JAIPUR,170219-Miranda Secondary School,29,304,0,304,0,0,0,0
23,105-CHANDIGARH,050532-Ningania Vidya Mandir High School,59,303,303,0,303,0,100,100
24,118-GANDHINAGAR,040088-Shree Sharda Secondary & High. Secondary School,59,303,303,0,195,108,100,64.36
25,105-CHANDIGARH,J05285-District Jail,61,302,0,302,0,0,0,0
26,102-PUNE,280004-St. Xavier's Academy,66,302,28,274,0,28,9.27,0
27,107-DELHI,270381-Saraswati Public Secondary School,54,301,207,94,0,207,68.77,0
28,109-JAIPUR,170322-Shivaji Bal Niketan Sr.sec. School,37,301,0,301,0,0,0,0
29,118-GANDHINAGAR,M04036-Hanifa School (english Medium),53,301,301,0,217,84,100,72.09
30,109-JAIPUR,170278-Jagriti Senior Secondary School,49,301,0,301,0,0,0,0
31,107-DELHI,050168-St.soldiers Sr.sec.Public School,61,301,35,266,0,35,11.63,0
32,103-KOLKATA,460507-Jagadishpur High School,51,300,295,5,112,183,98.33,37.33
33,105-CHANDIGARH,050296-Maharani Laxmi Bai Neo Convent,65,299,262,37,193,69,87.63,64.55
34,103-KOLKATA,220059-Indira Gandhi Memorial Sr.s. School,59,292,47,245,0,47,15.72,0
35,109-JAIPUR,170346-Sainik Vidhya Mandir Sr.sec. School,59,299,0,299,0,0,0,0
36,109-JAIPUR,170295-Oxbridge International Sr. Sec. School,68,298,294,4,294,0,98.66,98.66
37,105-CHANDIGARH,M05300-Mewat Modern Academy,58,298,297,1,218,79,99.66,73.15
38,107-DELHI,210239-Diwakar Model School,56,292,0,292,0,0,0,0
39,113-BHOPAL,M10228-Deniyat Fadeha  Madarsa,46,297,138,159,0,138,46.46,0
40,118-GANDHINAGAR,390106-M V S High school,57,297,297,0,265,32,100,89.23
41,103-KOLKATA,220096-Vivekanand Mission High School,51,294,238,56,3,235,80.95,1.02
42,105-CHANDIGARH,160153-Gurdasi Devi Institute of Management & Technology,62,294,294,0,30,264,100,10.2
43,118-GANDHINAGAR,390110-Govt. Khetivadi Sec. & High Sec. School,71,293,293,0,287,6,100,97.95
44,106-KOCHI,"M40008-Jdt Islam Orphanage & High School,",57,293,293,0,157,136,100,53.58
45,107-DELHI,270500-Navyug Happy Public School,62,292,292,0,200,92,100,68.49
46,101-HYDERABAD,"470011-T.s.w.rschool Jr.college(b),",50,291,2,289,2,0,0.69,0.69
47,107-DELHI,270545-Royal International School,59,291,289,2,86,203,99.31,29.55
48,109-JAIPUR,170305-Dr. Radhakrishnan Public Sec.school,38,290,218,72,0,218,75.17,0
49,118-GANDHINAGAR,390104-PRAGATI GIRLS HIGH SCHOOL,60,290,290,0,174,116,100,60
50,114-DEHRADUN,340292-Biswas Red Rose Inter College,64,290,290,0,290,0,100,100
51,114-DEHRADUN,340321-Subhash Smarak Inter College,49,287,0,287,0,0,0,0
52,102-PUNE,280009-Vivdha Vidya Pratisthan's,32,284,236,48,0,236,83.1,0
53,117-BENGALURU,M08049-Delhi Public School,68,272,226,46,129,97,79.58,45.42
54,115-BHUBANESWAR,150192-Centurion University of Technology and Management,44,283,251,32,86,165,88.69,30.39
55,104-GUWAHATI,130001-Kendriya Vidyalaya,53,281,281,0,22,259,100,7.83
56,109-JAIPUR,170333-Neha Public Sr.sec. School,48,280,280,0,267,13,100,95.36
57,107-DELHI,270287-Pt. Yadram Sec. Public School,53,280,280,0,125,155,100,44.64
58,107-DELHI,M27478-New Horizon School,58,279,277,2,200,77,99.28,71.68
59,104-GUWAHATI,020007-Kendriya Vidyalaya,53,278,91,187,3,88,32.73,1.08
60,114-DEHRADUN,340220-Kingston Public School,48,272,264,8,155,109,94.96,55.76
61,104-GUWAHATI,130023-Jawahar Navodaya Vidyalaya,56,275,133,142,23,110,48.36,8.36
62,111-ALLAHABAD/PRAYAGRAJ,210318-S.s.j.d Inter College,55,275,275,0,275,0,100,100
63,109-JAIPUR,170059-Arunodaya Shikshak Sansthan,56,273,0,273,0,0,0,0
64,107-DELHI,M27481-GURU NANAK PUBLIC SCHOOL,53,264,0,264,0,0,0,0
65,114-DEHRADUN,M21487-Kissan Public Inter College,57,269,267,2,267,0,99.26,99.26
66,118-GANDHINAGAR,M39053-St. Xavier's Vidya Vihar,51,269,269,0,252,17,100,93.68
67,114-DEHRADUN,340118-Govt. Inter College Champawat,54,265,189,76,7,182,71.32,2.64
68,107-DELHI,270291-Maharaja Aggarsain Public School,49,265,242,23,89,153,91.32,33.58
69,107-DELHI,050132-N.R.Hindu Sr.Sec.School,58,264,264,0,91,173,100,34.47
70,109-JAIPUR,170409-Gandhi Bal Niketan Sr. Sec. School,63,264,264,0,262,2,100,99.24
71,107-DELHI,050473-S.d. Senior Secondary School,50,264,264,0,264,0,100,100
72,104-GUWAHATI,020038-Kendriya Vidyalaya,57,263,88,175,2,86,33.46,0.76
73,103-KOLKATA,220129-Swami Vivekananda Vidyamandir,49,263,150,113,0,150,57.03,0
74,107-DELHI,210440-S S International School,52,261,5,256,5,0,1.92,1.92
75,106-KOCHI,090102-Kendriya Vidyalaya,52,261,99,162,0,99,37.93,0
76,117-BENGALURU,M08016-St. John's High School,48,252,232,20,143,89,88.89,54.79
77,107-DELHI,270540-Bhagat International School,35,260,0,260,0,0,0,0
78,107-DELHI,270447-D.R.P. Convent Secondary School,49,260,255,5,19,236,98.08,7.31
79,107-DELHI,270290-Prince Public School Sr. Sec.school,50,260,0,260,0,0,0,0
80,104-GUWAHATI,240026-ZENITH CHILD SCHOOL,58,258,34,224,14,20,13.18,5.43
81,109-JAIPUR,"170060-H.r. Memorial Public School,",50,257,212,45,212,0,82.49,82.49
82,111-ALLAHABAD/PRAYAGRAJ,210303-Janta Inter College,28,255,252,3,252,0,98.82,98.82
83,105-CHANDIGARH,"250003-Shivalik Public School, Mohali",50,254,196,58,2,194,77.17,0.79
84,115-BHUBANESWAR,150005-Redwoods English School,42,254,254,0,180,74,100,70.87
85,120-RANCHI,260097-+2 Zila School,50,254,254,0,253,1,100,99.61
86,114-DEHRADUN,M34253-Madarsa Maulana Abul Kalam Azad,45,253,253,0,229,24,100,90.51
87,107-DELHI,270408-RICHMONDD GLOBAL SCHOOL,35,252,0,252,0,0,0,0
88,120-RANCHI,260173-+2 Zila School,36,253,253,0,253,0,100,100
89,104-GUWAHATI,"M14017-St. Peter's School,",56,253,44,209,22,22,17.39,8.7
90,107-DELHI,050255-Tarun Niketan Sr.secondary School,49,252,0,252,0,0,0,0
91,107-DELHI,210439-S S K Sr.sec.school,58,251,0,251,0,0,0,0
92,107-DELHI,270006-St. Francis De Sales Sr.sec. School,46,247,164,83,51,113,65.6,20.4
93,115-BHUBANESWAR,410127-Centurion University Of Technology,43,248,244,4,115,129,97.99,46.18
94,114-DEHRADUN,210558-Jain Academy,27,249,0,249,0,0,0,0
95,107-DELHI,270332-Citizen Model School,48,249,247,2,100,147,99.2,40.16
96,114-DEHRADUN,340192-Jimp Pioneer School,42,247,247,0,246,1,100,99.6
97,111-ALLAHABAD/PRAYAGRAJ,M21353-Saint Kabir Inter College,52,246,246,0,246,0,100,100
98,114-DEHRADUN,340277-Matrabhumi Inter College,53,246,2,244,1,1,0.81,0.41
99,105-CHANDIGARH,050058-Yog High School,48,245,245,0,100,145,100,40.82
100,107-DELHI,270183-Vanasthali Public School,53,240,217,23,196,21,88.93,80.33
1,114-DEHRADUN,340003-Children's Academy,51,238,0,238,0,0,0,0
2,103-KOLKATA,220010-St. Teresa's Secondary School,51,243,0,243,0,0,0,0
3,105-CHANDIGARH,050026-New Era Senior Secondary School,53,243,241,2,241,0,99.18,99.18
4,107-DELHI,210510-Campus School,54,242,7,235,0,7,2.89,0
5,107-DELHI,270467-SIDHHARTHA PUBLIC SCHOOL,41,242,135,107,0,135,55.79,0
6,121-CHENNAI,190102-Vels Vidyashram,58,239,210,29,190,20,87.5,79.17
7,101-HYDERABAD,470196-Kendriya Vidyalaya,51,237,0,237,0,0,0,0
8,107-DELHI,270147-Mount St. Mary's,51,238,237,1,236,1,99.58,99.16
9,115-BHUBANESWAR,450122-Srusti Society For Rural,41,235,234,1,221,13,99.57,94.04
10,114-DEHRADUN,210403-Khalsa Public Inter College,56,235,235,0,235,0,100,100
11,105-CHANDIGARH,050660-R.K. International School,49,234,234,0,0,234,100,0
12,123-GANGTOK,180004-Deorali Govt.sr.sec. School,51,234,234,0,187,47,100,79.91
13,105-CHANDIGARH,160022-Punjab Model Sr. Sec School,43,233,161,72,0,161,69.1,0
14,108-ABROAD/NIOS HQ,950018-Time Training Centre,46,232,232,0,232,0,100,100
15,114-DEHRADUN,340143-Mahesha Nand  Bahuguna Inter,45,232,232,0,232,0,100,100
16,118-GANDHINAGAR,040037-Shree Swaminarayan Academy,46,230,230,0,146,84,99.57,63.2
17,105-CHANDIGARH,050649-B.P.R. Public School,34,231,231,0,0,231,100,0
18,107-DELHI,050156-Adharsh Bal Vidya Kendrasr.s.school,44,225,217,8,125,92,93.94,54.11
19,107-DELHI,270401-Cosmos School,46,230,0,230,0,0,0,0
20,113-BHOPAL,100184-Sarvodaya Higher Secondary School,54,228,228,0,165,63,100,72.37
21,102-PUNE,280005-Vivekanand Vidyalaya,40,228,228,0,0,228,100,0
22,107-DELHI,050162-SARASWATI SR.SEC.SCHOOL,42,228,0,228,0,0,0,0
23,107-DELHI,270419-C.r. Oasis Convent School,40,225,0,225,0,0,0,0
24,105-CHANDIGARH,160113-Himalaya Modern Sr.sec. School,46,225,220,5,220,0,97.78,97.78
25,118-GANDHINAGAR,040075-Shannen Kids School,48,224,223,1,131,92,99.11,58.22
26,109-JAIPUR,170354-OM VIDYA MANDIR SR. SEC. SCHOOL,47,225,14,211,0,14,6.22,0
27,123-GANGTOK,220079-Godwin Modern School,42,224,137,87,118,19,61.16,52.68
28,103-KOLKATA,220016-St. James High School,48,224,0,224,0,0,0,0
29,120-RANCHI,260171-S.s. +2 High School,55,222,0,222,0,0,0,0
30,121-CHENNAI,450011-The Spastic Society Of Tamilnadu,46,220,206,14,49,157,92.79,22.07
31,107-DELHI,270524-Srilal Convent Sr. Secondary School,40,221,217,4,0,217,98.19,0
32,118-GANDHINAGAR,040078-Pragati International School,29,221,221,0,221,0,100,100
33,105-CHANDIGARH,050169-Maharishi Vidya Mandir,49,220,65,155,2,63,29.55,0.91
34,113-BHOPAL,M10274-Madarsa Nascent Diniyat,29,219,217,2,217,0,99.09,99.09
35,107-DELHI,M27488-Kalgidhar Khalsa Sr. Sec. School,46,217,216,1,210,6,99.54,96.77
36,107-DELHI,270501-NATHU RAM CONVENT SCHOOL,46,216,160,56,0,160,74.07,0
37,103-KOLKATA,230005-Govt. Senior Secondary School,34,216,0,216,0,0,0,0
38,105-CHANDIGARH,160110-H.s.d. Girls Sr. Sec. School,43,215,0,215,0,0,0,0
39,115-BHUBANESWAR,150202-MAHAMAYA JR. COLLEGE,40,215,106,109,69,37,49.3,32.09
40,118-GANDHINAGAR,390062-Bright High School,33,213,212,1,155,57,99.53,72.77
41,107-DELHI,M27402-St.marys School,40,213,213,0,61,152,100,28.64
42,114-DEHRADUN,M21368-Madarsa Islahul Muslimeen,37,213,213,0,0,213,100,0
43,107-DELHI,270360-Holy Convent Sr. Sec School,37,212,210,2,148,62,98.59,69.48
44,114-DEHRADUN,340061-Modern School,49,210,0,210,0,0,0,0
45,104-GUWAHATI,020076-Bishnu Rabha High School,48,211,211,0,144,67,100,68.25
46,102-PUNE,110115-Navneet Jr. College Of Arts,42,209,173,36,133,40,82.78,63.64
47,104-GUWAHATI,020036-Kendriya Vidyalaya,40,209,54,155,4,50,25.84,1.91
48,107-DELHI,270341-Jain Bharti Model School,40,208,0,208,0,0,0,0
49,105-CHANDIGARH,050226-Gyan Deep Sr.Sec School,39,208,0,208,0,0,0,0
50,106-KOCHI,090007-Anjali Hindi College,41,207,120,87,61,59,57.97,29.47
51,117-BENGALURU,M08021-Deffodils High School,38,207,207,0,179,28,100,86.47
52,105-CHANDIGARH,M05444-Mata Gujri Public School,39,206,0,206,0,0,0,0
53,104-GUWAHATI,020074-Adarsha Hindi Vidyalaya H.E. School,48,206,58,148,27,31,28.16,13.11
54,105-CHANDIGARH,M16108-Khalsa Public Sr.Sec. School,45,206,205,1,90,115,99.51,43.69
55,107-DELHI,050085-Holy Child Sr. Sec. School,35,206,206,0,206,0,100,100
56,107-DELHI,050408-S.d.m. High School,43,206,205,1,205,0,99.51,99.51
57,104-GUWAHATI,020015-Sree Narasinghasthan High School,36,206,92,114,21,71,44.66,10.19
58,104-GUWAHATI,130024-Montfort Hr.secondary School,40,200,57,143,3,54,27.8,1.46
59,103-KOLKATA,220052-Maria's Day School,42,205,168,37,168,0,81.95,81.95
60,103-KOLKATA,460516-Midnapore Town School,38,205,205,0,103,102,100,50.24
61,107-DELHI,270453-New Sainik Public School,38,204,187,17,187,0,91.22,91.22
62,107-DELHI,270412-B.S.M. Public School,45,204,132,72,0,132,64.71,0
63,103-KOLKATA,220025-St. Mary Gorretti Girls' High School,40,203,0,203,0,0,0,0
64,114-DEHRADUN,210212-Modern Public School,42,202,6,196,0,6,2.97,0
65,104-GUWAHATI,140030-Mayangnokcha Govt. Hr.Sec. School,35,202,53,149,20,33,26.24,9.9
66,104-GUWAHATI,M02071-KANCHANPUR MEDHA VIKASH VIDYALAYA,44,202,202,0,32,170,100,15.84
67,107-DELHI,270526-S.D Hari Mandir Girls Sr. Sec. School,40,200,200,0,85,115,100,42.5
68,109-JAIPUR,170405-GAYATRI VIDYA MANDIR SR. SEC. SCHOOL,38,200,200,0,200,0,100,100
69,109-JAIPUR,170285-Newai Vidyapeeth Sr.sec. School,27,200,0,200,0,0,0,0
70,103-KOLKATA,M22100-SAMARITAN MISSION SCHOOL(HIGH),43,199,199,0,186,13,100,93.47
71,107-DELHI,"270399-Decent Public School, Rohini",41,199,0,199,0,0,0,0
72,103-KOLKATA,M38111-Anglo Arabic Secondary School,42,198,188,10,171,17,94.95,86.36
73,107-DELHI,210755-COLUMBIA CONVENT INSTITUTE,39,198,0,198,0,0,0,0
74,118-GANDHINAGAR,040089-Taxshila Vidyalaya,36,198,198,0,198,0,100,100
75,114-DEHRADUN,M38268-Jamia Qasmia Darul Uloom,28,197,0,197,0,0,0,0
76,115-BHUBANESWAR,410130-410130-Brajamohan High School,33,197,140,57,89,51,71.07,45.18
77,107-DELHI,270436-B.S.M. Senior Secondary School,41,197,185,12,0,185,93.91,0
78,114-DEHRADUN,M38367-Muslim Inter College,49,196,0,196,0,0,0,0
79,104-GUWAHATI,M02023-Mont Fort School,39,196,139,57,15,124,70.92,7.65
80,115-BHUBANESWAR,150006-Daniel Public School,28,195,195,0,132,63,100,67.69
81,105-CHANDIGARH,050612-Vishwas Nav Sharda Public School,37,194,29,165,0,29,14.95,0
82,104-GUWAHATI,020063-Sai Rns Academy,39,193,66,127,13,53,34.2,6.74
83,104-GUWAHATI,M13019-Nabhajyoti Paham G/A Hr. Sec. School,31,193,86,107,38,48,44.56,19.69
84,107-DELHI,050601-Doon Bharti Public Sr. sec School,38,193,0,193,0,0,0,0
85,109-JAIPUR,170381-SHIV BAL VIDYA MANDIR SR. SEC. SCHOOL,31,192,192,0,192,0,100,100
86,114-DEHRADUN,340211-Himalaya Vidya Mandir Sr.sec.school,40,190,189,1,168,21,99.47,88.42
87,104-GUWAHATI,120014-Ma Whab Islamic For S.c.pub.school,37,187,182,5,115,67,97.33,61.5
88,120-RANCHI,260205-KASIDIH HIGH SCHOOL,34,186,0,186,0,0,0,0
89,105-CHANDIGARH,M16061-Mother Chhan Kaur Convent School,37,186,186,0,186,0,100,100
90,107-DELHI,270207-Govt Sarvodaya Co Ed.vidyalaya,38,186,0,186,0,0,0,0
91,107-DELHI,270154-Govt. Sarvodaya Bal Vidyalaya,36,186,0,186,0,0,0,0
92,118-GANDHINAGAR,390112-Shree Krishna Secondary Higher Secondary School,19,185,183,2,158,25,98.92,85.41
93,109-JAIPUR,170424-Choudhary Bal Sr. Sec. School,43,185,184,1,150,34,99.46,81.08
94,109-JAIPUR,170419-Baldev Public Sr. Sec. School,33,184,132,52,0,132,71.74,0
95,118-GANDHINAGAR,M39052-Shama High School,36,184,184,0,181,3,100,98.37
96,102-PUNE,M11066-Fr. Agnel Multipurpose School,46,177,176,1,51,125,96.17,27.87
97,105-CHANDIGARH,160078-Jawahar Navodaya Vidyalaya,34,183,183,0,54,129,100,29.51
98,107-DELHI,050593-D R A Sr. Secondary School,44,182,174,8,109,65,95.6,59.89
99,107-DELHI,210249-S.g.public School,39,181,0,181,0,0,0,0
100,120-RANCHI,260046-D A V Kapildev Public School,32,181,0,181,0,0,0,0
1,114-DEHRADUN,340126-Govt. Intermediate College,42,180,0,180,0,0,0,0
2,105-CHANDIGARH,050445-M. S. Senior Secondary School,37,181,181,0,44,137,100,24.31
3,109-JAIPUR,170297-Kamla Shikshan Sansthan,33,181,175,6,0,175,96.69,0
4,117-BENGALURU,080005-St. Ann's High School,33,180,162,18,0,162,90,0
5,107-DELHI,"270388-Brahma Shakti Public School,",35,178,0,178,0,0,0,0
6,104-GUWAHATI,"200016-Amarpur Boys Hr.sec.school,",33,178,178,0,21,157,100,11.8
7,107-DELHI,270468-Sky Hawk International School,29,178,0,178,0,0,0,0
8,107-DELHI,"M27376-Carmel Convent School,",38,178,173,5,36,137,97.19,20.22
9,102-PUNE,110139-Kendriya Vidyalaya,38,178,164,14,76,88,92.13,42.7
10,103-KOLKATA,460514-Lakhuria High School,33,177,0,177,0,0,0,0
11,114-DEHRADUN,340316-Sangam Children Academy,36,176,0,176,0,0,0,0
12,105-CHANDIGARH,050108-Arya Senior Secondary School,36,176,176,0,176,0,100,100
13,104-GUWAHATI,M02069-Jaleswar Girls Higher secondary School,47,176,176,0,176,0,100,100
14,107-DELHI,"270141-Govt. Sarvodaya Bal Vidyalaya, Ramesh Nagar",37,174,0,174,0,0,0,0
15,114-DEHRADUN,340191-Dayanand Inter College,32,174,174,0,113,61,100,64.94
16,106-KOCHI,M09076-Narikkuni English Medium School,35,174,0,174,0,0,0,0
17,109-JAIPUR,170371-Global International Academy,31,174,0,174,0,0,0,0
18,121-CHENNAI,190068-Govt. Boys Higher Secondary School,58,174,0,174,0,0,0,0
19,105-CHANDIGARH,050632-Divine Light Sr. Sec. School,26,173,59,114,0,59,34.1,0
20,118-GANDHINAGAR,040010-Logos Mission Hr.sec School,40,170,169,1,128,41,98.26,74.42
21,109-JAIPUR,170392-Adarsh Bal Nikunj Sr.Sec.School,36,172,0,172,0,0,0,0
22,107-DELHI,270531-Daffodil Public School,39,172,146,26,30,116,84.88,17.44
23,106-KOCHI,M09104-HAIL MARY ENGLISH MEDIUM Resi. HS School,32,166,164,2,121,43,95.91,70.76
24,118-GANDHINAGAR,390077-Saraswat International Academy,37,171,171,0,171,0,100,100
25,118-GANDHINAGAR,390086-Ranuj High School,32,170,170,0,167,3,100,98.24
26,105-CHANDIGARH,050378-Navyug Shiksha Niketan Sr.Sec.school,27,170,0,170,0,0,0,0
27,115-BHUBANESWAR,J15160-Circle Jail,34,170,80,90,80,0,47.06,47.06
28,105-CHANDIGARH,050211-Nirmal Sr. Sec. Public School,37,169,0,169,0,0,0,0
29,118-GANDHINAGAR,390105-V.D.T Girls High School,31,169,169,0,112,57,100,66.27
30,111-ALLAHABAD/PRAYAGRAJ,210182-Bal Vidyapeeth,37,169,0,169,0,0,0,0
31,107-DELHI,270506-C.M. MODEL SCHOOL,31,166,5,161,0,5,2.98,0
32,109-JAIPUR,170272-Vikas Public School,35,168,164,4,91,73,97.62,54.17
33,114-DEHRADUN,210694-St. Mary's School,39,168,167,1,166,1,99.4,98.81
34,118-GANDHINAGAR,390121-Swami Vivekanand Vidhyalaya,27,167,167,0,137,30,100,82.04
35,118-GANDHINAGAR,390082-SUNGRACE VIDHYALAYA,33,166,166,0,148,18,99.4,88.62
36,105-CHANDIGARH,M16042-St. Soldier Inter. Convent School,32,167,77,90,0,77,46.11,0
37,106-KOCHI,M09065-Ideal English Hr.sec.school,34,167,0,167,0,0,0,0
38,120-RANCHI,260075-Vidya Vihar Girls High School,31,167,0,167,0,0,0,0
39,105-CHANDIGARH,160135-G.G.S. Public Sr.Sec. School,32,166,0,166,0,0,0,0
40,105-CHANDIGARH,050404-Spring Daisy Convent School,32,166,93,73,0,93,56.02,0
41,113-BHOPAL,100053-Saraswati Hr. Sec. School Gondkala,34,166,166,0,93,73,100,56.02
42,104-GUWAHATI,200010-Kendriya Vidyalaya,41,166,120,46,48,72,72.29,28.92
43,103-KOLKATA,230011-Govt. Senior Secondary School,29,165,114,51,0,114,69.09,0
44,121-CHENNAI,190100-Smt. Narbada Devi J. Agarwal,26,127,123,4,91,32,74.55,55.15
45,125-JAMMU,070022-Bright Furture Higher Secondary,40,162,32,130,17,15,19.39,10.3
46,106-KOCHI,M40006-Ai-ameen College,32,164,0,164,0,0,0,0
47,105-CHANDIGARH,050450-Arya Senior Secondary School,35,163,163,0,124,39,100,76.07
48,103-KOLKATA,220125-Boon English School,30,163,0,163,0,0,0,0
49,109-JAIPUR,170081-Children Sr. School,37,162,142,20,105,37,87.65,64.81
50,115-BHUBANESWAR,150031-Kendriya Vidyalaya,29,161,133,28,88,45,82.61,54.66
51,113-BHOPAL,"100073-Janta Higher Secondary School,",33,161,148,13,148,0,91.93,91.93
52,101-HYDERABAD,470002-St. Vincent High School,26,160,132,28,0,132,81.99,0
53,105-CHANDIGARH,050370-Kalyan Sr.sec. School,28,161,55,106,19,36,34.16,11.8
54,107-DELHI,270494-U.S.M. Public Sr.Sec. School,29,161,161,0,0,161,100,0
55,114-DEHRADUN,210237-Amorha Muslim Girls Inter College,35,160,0,160,0,0,0,0
56,121-CHENNAI,M19103-Al Hira Model School,34,155,154,1,29,125,96.25,18.13
57,107-DELHI,270457-Rani Public School,34,160,39,121,0,39,24.38,0
58,109-JAIPUR,170243-Govt. Sardar Hr. Secondary School,29,160,0,160,0,0,0,0
59,102-PUNE,280002-Auxilium High School,28,153,146,7,14,132,92.41,8.86
60,105-CHANDIGARH,050046-Saini Sr.sec.school,27,158,7,151,0,7,4.43,0
61,123-GANGTOK,220030-Nepali Girls Social Service Centre,28,158,157,1,156,1,99.37,98.73
62,103-KOLKATA,220044-Kendriya Vidyalaya,33,148,0,148,0,0,0,0
63,107-DELHI,270519-Upadhyay Convent School,31,157,157,0,0,157,100,0
64,115-BHUBANESWAR,150199-KALINGA INSTITUTE OF SOCIAL SCIENCES (KISS),33,156,106,50,48,58,67.95,30.77
65,114-DEHRADUN,340270-Govt. Inter College,32,156,156,0,156,0,100,100
66,105-CHANDIGARH,050367-Shiksha Bharti Vidya Niketan,32,155,0,155,0,0,0,0
67,118-GANDHINAGAR,"M04025-Don Bosco High School,",32,155,152,3,97,55,98.06,62.58
68,105-CHANDIGARH,050407-A. Xavier's International School,29,155,0,155,0,0,0,0
69,106-KOCHI,M09097-Hsm Higher Secondary School,31,155,0,155,0,0,0,0
70,107-DELHI,270556-Evergreen Public School,32,155,155,0,155,0,100,100
71,114-DEHRADUN,210174-AMAR SHAHEED MEMORIAL INTER COLLEGE,34,154,154,0,153,1,100,99.35
72,104-GUWAHATI,140015-Eastern School,34,154,154,0,153,1,100,99.35
73,120-RANCHI,260001-Indian School Of Learning,34,154,17,137,0,17,11.04,0
74,113-BHOPAL,"M10066-Annie Besant Higher Sec School,",32,153,106,47,0,106,68.83,0
75,120-RANCHI,260030-Ramakrishna Mission Ashrama,29,152,152,0,152,0,99.35,99.35
76,106-KOCHI,090101-Kendriya Vidyalaya,27,153,5,148,5,0,3.27,3.27
77,106-KOCHI,090056-Kendriya Vidyalaya,35,153,143,10,104,39,93.46,67.97
78,103-KOLKATA,220103-Budge Budge St. Pauls Day School,29,153,0,153,0,0,0,0
79,107-DELHI,050019-Kendriya Vidyalaya No. 1,33,152,0,152,0,0,0,0
80,105-CHANDIGARH,M16116-GOLDEN PUBLIC SCHOOL,30,151,79,72,0,79,52.32,0
81,104-GUWAHATI,M13016-St.xavier's Secondary School,30,151,149,2,126,23,98.68,83.44
82,105-CHANDIGARH,050619-Oxford Public School,22,151,0,151,0,0,0,0
83,103-KOLKATA,220078-Vidya Niketan,29,151,0,151,0,0,0,0
84,109-JAIPUR,M17270-S.k. Green Wood Shikshan Sansthan,24,150,11,139,0,11,7.33,0
85,102-PUNE,280003-Copuchin Friars Minor Society,26,150,126,24,26,100,84,17.33
86,107-DELHI,210667-Nilgiri Hills Public School,29,149,0,149,0,0,0,0
87,118-GANDHINAGAR,390074-Nootan Bharti Vidyalaya,22,149,149,0,125,24,100,83.89
88,107-DELHI,270383-Mater Dei School,31,149,0,149,0,0,0,0
89,114-DEHRADUN,M21488-Jamia Farooquia Azizul Uloom ,27,148,144,4,136,8,97.3,91.89
90,107-DELHI,050053-Bal Vikas High School,29,148,148,0,146,2,100,98.65
91,107-DELHI,270537-Tyagi Public School,27,147,147,0,139,8,100,94.56
92,114-DEHRADUN,340127-Govt. Inter College,30,147,124,23,124,0,84.35,84.35
93,125-JAMMU,070029-Jawahar Navodaya Vidyalaya,33,147,142,5,50,92,96.6,34.01
94,114-DEHRADUN,210207-Naveen Kumar Bharti Shishu Upwan Inter College,36,147,147,0,147,0,100,100
95,109-JAIPUR,170400-Subodh Vidya Mandir Sr. Sen School,24,147,0,147,0,0,0,0
96,110-PATNA,030103-Brijishore Dharnighar Rajkiya Balak,27,141,23,118,4,19,15.65,2.72
97,104-GUWAHATI,M02061-Abdul Hasib Higher Secondary School,26,146,146,0,133,13,100,91.1
98,102-PUNE,M11037-Don Bosco High School Jr.College,37,138,108,30,9,99,73.97,6.16
99,105-CHANDIGARH,050635-The Scholars Public School,32,146,0,146,0,0,0,0
100,123-GANGTOK,180015-Govt. Senior Secondary School,32,146,144,2,138,6,98.63,94.52
1,102-PUNE,M38349-Al Ameen English High School,21,146,0,146,0,0,0,0
2,106-KOCHI,090070-Jawahar Navodaya Vidyalaya,25,132,132,0,84,48,91.03,57.93
3,102-PUNE,M11131-DON BOSCO SENIOR SECONDARY SCHOOL,30,144,0,144,0,0,0,0
4,107-DELHI,270461-M.N.B. Modern Secondary School,33,144,144,0,40,104,100,27.78
5,109-JAIPUR,170242-Shahid Amit Bhardwaj Govt. Senior,30,144,139,5,139,0,96.53,96.53
6,102-PUNE,280001-Pope John Xxiii High School,26,144,144,0,143,1,100,99.31
7,114-DEHRADUN,340084-Maharishi Vidya Mandir,35,143,0,143,0,0,0,0
8,109-JAIPUR,170204-Raghuraj Academy,29,143,143,0,143,0,100,100
9,105-CHANDIGARH,M16044-Kirpal Sagar Academy,28,143,143,0,0,143,100,0
10,114-DEHRADUN,340311-Ambition Public Sr.Sec. School,32,143,0,143,0,0,0,0
11,107-DELHI,050542-Vidya School,25,141,0,141,0,0,0,0
12,105-CHANDIGARH,050215-Holy Heart Sec School,21,142,0,142,0,0,0,0
13,109-JAIPUR,M17091-Jametur Hidaya,30,142,127,15,117,10,89.44,82.39
14,118-GANDHINAGAR,040099-S S School of Science,28,142,142,0,121,21,100,85.21
15,107-DELHI,210595-Unique International Public School,20,142,0,142,0,0,0,0
16,107-DELHI,270302-Indra Prastha Convent Sr.sec.school,28,142,142,0,142,0,100,100
17,110-PATNA,"030258-R.m.k. Inter School,",30,141,0,141,0,0,0,0
18,103-KOLKATA,230014-Govt. Model Senior Secondary School,23,136,112,24,0,112,79.43,0
19,107-DELHI,050366-C.D. International School,27,138,0,138,0,0,0,0
20,107-DELHI,270491-Rahul Public School,27,141,122,19,0,122,86.52,0
21,102-PUNE,110012-Sandesh Vidyalaya College Of Arts,21,138,138,0,138,0,97.87,97.87
22,107-DELHI,050627-Shivalik Educational Academy,26,141,0,141,0,0,0,0
23,115-BHUBANESWAR,410119-The Assembly Of God School,17,141,84,57,52,32,59.57,36.88
24,111-ALLAHABAD/PRAYAGRAJ,M21606-Sri Vardhaman Inter College,27,140,140,0,140,0,100,100
25,107-DELHI,210507-Saraswati Shiksha Niketan Inter College,26,139,0,139,0,0,0,0
26,118-GANDHINAGAR,390053-Gracious English,28,138,138,0,138,0,100,100
27,114-DEHRADUN,340296-Scholar Beam Sr. Sec. School,24,138,0,138,0,0,0,0
28,117-BENGALURU,M08047-Karunya Independent Pu College,20,137,31,106,0,31,22.63,0
29,107-DELHI,270377-Nav Gian Deep Sr. Sec. Public School,25,137,0,137,0,0,0,0
30,109-JAIPUR,170062-LBS CONVENT SENIOR SECONDARY SCHOOL,25,137,0,137,0,0,0,0
31,118-GANDHINAGAR,040054-Maruti High School,24,137,137,0,110,27,100,80.29
32,121-CHENNAI,M19101-Crescent Matric Hr.sec. School,26,135,135,0,135,0,98.54,98.54
33,123-GANGTOK,180017-Govt. Senior Secondary School,27,137,14,123,14,0,10.22,10.22
34,105-CHANDIGARH,050403-Mrcr Public School,31,137,10,127,0,10,7.3,0
35,114-DEHRADUN,340249-Janki Children Academy,29,135,132,3,119,13,97.06,87.5
36,123-GANGTOK,180016-Govt. Senior Secondary School,29,136,96,40,73,23,70.59,53.68
37,110-PATNA,030058-Kendriya Vidyalaya,27,134,0,134,0,0,0,0
38,121-CHENNAI,190112-B.v.m. Global,25,135,125,10,26,99,92.59,19.26
39,102-PUNE,"110017-M. G. M. Academy's Junior College of Arts, Commerce & Science",29,131,129,2,129,0,96.27,96.27
40,118-GANDHINAGAR,390059-St. Xavier's Social Service Soceity,21,133,133,0,117,16,100,87.97
41,106-KOCHI,M09109-St. John's Public School,26,133,0,133,0,0,0,0
42,105-CHANDIGARH,050573-CHARAN SINGH MEMORIAL CONVENT SR. SEC. SCHOOL,21,132,0,132,0,0,0,0
43,107-DELHI,270479-P.D. Model Senior Secondary School,24,131,0,131,0,0,0,0
44,114-DEHRADUN,210228-Gyandeep Sr.secondary School,26,131,93,38,93,0,70.99,70.99
45,111-ALLAHABAD/PRAYAGRAJ,210034-Kendriya Vidyalaya,33,131,0,131,0,0,0,0
46,105-CHANDIGARH,J05007-Distt. Jail,23,131,0,131,0,0,0,0
47,114-DEHRADUN,340236-M.p. Hindu Inter College,27,131,131,0,107,24,100,81.68
48,105-CHANDIGARH,050583-KAPIL VIDYA MANDIR SR. SEC. SCHOOL,28,131,0,131,0,0,0,0
49,103-KOLKATA,230003-Name 5132,23,129,59,70,1,58,45.38,0.77
50,107-DELHI,270451-Tulip International School,24,130,0,130,0,0,0,0
51,109-JAIPUR,170280-Lovely Diamond Senior Sec.school,32,130,0,130,0,0,0,0
52,115-BHUBANESWAR,410129-410129-Police High School,27,130,93,37,62,31,71.54,47.69
53,105-CHANDIGARH,050148-Saraswati Vidya Mandir High School,19,130,0,130,0,0,0,0
54,109-JAIPUR,170391-Bal Gopal Sr.Sec. School,26,130,0,130,0,0,0,0
55,103-KOLKATA,230004-Government Sr. Secondary School,23,130,103,27,50,53,79.23,38.46
56,114-DEHRADUN,340171-City Public Inter College,25,129,119,10,119,0,92.25,92.25
57,104-GUWAHATI,120028-The Tentha High School,27,129,129,0,82,47,100,63.57
58,110-PATNA,030070-+2 M.l.academy,31,128,15,113,4,11,11.72,3.13
59,107-DELHI,"450077-DEEPALAYA Y/4A,",20,128,0,128,0,0,0,0
60,105-CHANDIGARH,160026-Everest Public Sr. Sec. School,26,128,0,128,0,0,0,0
61,111-ALLAHABAD/PRAYAGRAJ,210791-K S Pandey Public Academy,28,128,108,20,0,108,84.38,0
62,107-DELHI,050376-Yadav Academy Public High School,25,128,0,128,0,0,0,0
63,107-DELHI,210441-S. V. Vidya Mandir Inter College,26,127,127,0,119,8,100,93.7
64,106-KOCHI,M40054-Markazul Uloom English School,25,127,0,127,0,0,0,0
65,109-JAIPUR,M17117-Children Sr.sec.school,33,122,122,0,110,12,96.06,86.61
66,105-CHANDIGARH,050640-Shivalik Sr. Sec. School,27,127,0,127,0,0,0,0
67,110-PATNA,"030325-Mandwari +2 High School,",27,127,124,3,91,33,97.64,71.65
68,115-BHUBANESWAR,410121-Kendriya Vidyalaya,21,126,73,53,41,32,57.48,32.28
69,115-BHUBANESWAR,410135-410135-AJO HIGH SCHOOL,27,126,126,0,100,26,100,79.37
70,106-KOCHI,M09088-Iqra Islamic Women's College,24,126,126,0,126,0,100,100
71,102-PUNE,M11084-Sir Sayyad English High School,18,126,53,73,0,53,42.06,0
72,120-RANCHI,260100-Jamshedpur Balika Ucch Vidyalaya,21,125,0,125,0,0,0,0
73,114-DEHRADUN,M38160-H.b.h.inter College,32,126,0,126,0,0,0,0
74,107-DELHI,270269-Happy Senior School,22,126,86,40,0,86,68.25,0
75,104-GUWAHATI,240028-Govt. Secondary School,25,126,18,108,16,2,14.29,12.7
76,107-DELHI,210797-Bansraj Model School,29,125,125,0,125,0,100,100
77,118-GANDHINAGAR,390060-Tree House High School,28,125,125,0,123,2,100,98.4
78,117-BENGALURU,M38354-SHAHEEN URDU HIGH SCHOOL,25,125,125,0,125,0,100,100
79,107-DELHI,270505-Har Govind Secondary Public School,29,124,124,0,124,0,100,100
80,107-DELHI,270538-Rama Public School,19,124,119,5,0,119,95.97,0
81,114-DEHRADUN,340243-Govt. Inter College,28,124,63,61,0,63,50.81,0
82,107-DELHI,"210335-Moolchand Chauhan Public School,",23,124,55,69,0,55,44.35,0
83,105-CHANDIGARH,M16060-Rose Mary Convent School,27,123,123,0,120,3,100,97.56
84,105-CHANDIGARH,160080-Malwa Sr.secondary School,25,122,122,0,119,3,99.19,96.75
85,116-VISAKHAPATNAM,010146-Sri Adithya Junior College,21,123,123,0,1,122,100,0.81
86,109-JAIPUR,170109-K R Adarsh Sr.Sec.School,30,122,120,2,70,50,98.36,57.38
87,107-DELHI,050107-T. T. Public School,24,122,0,122,0,0,0,0
88,107-DELHI,270068-Kendriya Vidyalaya,23,121,0,121,0,0,0,0
89,107-DELHI,210771-Diamond Public School,19,122,117,5,0,117,95.9,0
90,121-CHENNAI,190029-Kendriya Vidyalaya,30,118,0,118,0,0,0,0
91,113-BHOPAL,J10004-Central Jail Bhopal,24,121,0,121,0,0,0,0
92,109-JAIPUR,170324-L.b.s. Academy Sr.sec. School,12,121,121,0,119,2,100,98.35
93,104-GUWAHATI,020004-Kamrup Academy Hr. Sec. School,26,121,39,82,8,31,32.23,6.61
94,105-CHANDIGARH,050128-Nalwa Lovely Public School,26,121,121,0,2,119,100,1.65
95,107-DELHI,050663-Modish Public School,30,120,0,120,0,0,0,0
96,120-RANCHI,"260067-D.a.v. Model School,",23,120,0,120,0,0,0,0
97,109-JAIPUR,170144-Tilak Bal Mandir Sr.sec.school,22,120,79,41,67,12,65.83,55.83
98,114-DEHRADUN,340297-Riverain Public School,27,120,120,0,101,19,100,84.17
99,109-JAIPUR,170338-Tagore Public Sr.sec. School,25,120,0,120,0,0,0,0
100,118-GANDHINAGAR,040041-Kendriya Vidyalaya,22,119,119,0,65,54,100,54.62
1,105-CHANDIGARH,160019-S.d.girls Sr. Sec. School,25,119,0,119,0,0,0,0
2,114-DEHRADUN,340115-Govt. Inter Mediate College,25,118,0,118,0,0,0,0
3,107-DELHI,"270389-B.v.m. Model School,",24,118,78,40,0,78,66.1,0
4,107-DELHI,210710-Dolphin Public School,24,117,8,109,0,8,6.78,0
5,118-GANDHINAGAR,390088-Bansidhar Vidyalaya,28,118,118,0,113,5,100,95.76
6,105-CHANDIGARH,050078-Buniyad Senior Secondary School,18,118,0,118,0,0,0,0
7,114-DEHRADUN,340117-Swatantrata Sangram Senani Shaheed,22,117,117,0,116,1,100,99.15
8,118-GANDHINAGAR,040081-M V S High School,23,117,117,0,76,41,100,64.96
9,104-GUWAHATI,M02076-SL COLLEGIATE HIGH SCHOOL,27,117,84,33,47,37,71.79,40.17
10,107-DELHI,M27233-Baba Banda Singh Memo. Sec. School,18,112,0,112,0,0,0,0
11,114-DEHRADUN,210763-M.D International School,23,116,0,116,0,0,0,0
12,107-DELHI,270458-Heera Lal Public School,21,111,0,111,0,0,0,0
13,114-DEHRADUN,340215-Govt. Inter College,25,116,0,116,0,0,0,0
14,107-DELHI,270528-Yash Vidya Public School,24,115,0,115,0,0,0,0
15,104-GUWAHATI,M02060-Maryam Ajmal Woken's College Of,26,115,115,0,115,0,100,100
16,109-JAIPUR,170388-Sanskar Public Sr.Sec. School,17,115,115,0,89,26,100,77.39
17,115-BHUBANESWAR,150171-Centurion University Of Technology,24,115,115,0,43,72,100,37.39
18,110-PATNA,"030288-B.n.collegiate School,",24,114,6,108,5,1,5.26,4.39
19,102-PUNE,110126-SAILEE INTERNATIONAL SCHOOL  & JUNIOR COLLEGE,24,114,114,0,82,32,100,71.93
20,107-DELHI,270492-Adarsh GyanSarover Balika Vidyalaya,21,113,113,0,105,8,100,92.92
21,121-CHENNAI,190022-The Gandhi Gram Rural Institute,19,113,0,113,0,0,0,0
22,104-GUWAHATI,020050-Jawahar Navodaya Vidyalaya,27,111,53,58,14,39,46.9,12.39
23,111-ALLAHABAD/PRAYAGRAJ,210169-Smt. Ram Katori Varshney Inter,25,112,112,0,112,0,100,100
24,104-GUWAHATI,020069-Pranab Jubilee College,28,112,57,55,2,55,50.89,1.79
25,118-GANDHINAGAR,040093-Sanskartirth Gyanpeeth,23,112,112,0,104,8,100,92.86
26,106-KOCHI,400053-Kendriya Vidyalaya,20,111,0,111,0,0,0,0
27,121-CHENNAI,420089-The Vikasa School,17,111,0,111,0,0,0,0
28,107-DELHI,210243-Anamika Girls Hr. Sec. School,20,110,110,0,14,96,100,12.73
29,114-DEHRADUN,V34001-Doon Vadic Shiksha Samiti,21,110,5,105,0,5,4.55,0
30,107-DELHI,270543-Himalaya Public Sr. Secondary School,20,110,0,110,0,0,0,0
31,103-KOLKATA,220075-Sibpur Ambika Hindi High School,23,110,0,110,0,0,0,0
32,102-PUNE,110145-Akshara International School,29,102,65,37,1,64,59.63,0.92
33,105-CHANDIGARH,050522-Guru Nanak Sr.Sec.School,21,107,107,0,53,54,98.17,48.62
34,104-GUWAHATI,020039-Kendriya Vidyalaya,25,97,87,10,36,51,80.56,33.33
35,122-DHARAMSALA,060083-Blue Star Public Sr.sec. School,17,108,70,38,68,2,64.81,62.96
36,114-DEHRADUN,340190-Shri Ravi Dutt Bahuguna High School,22,108,0,108,0,0,0,0
37,105-CHANDIGARH,050589-Modern Hind Sr. Sec. School,23,108,107,1,31,76,99.07,28.7
38,125-JAMMU,070001-Presentation Convent High School,23,107,0,107,0,0,0,0
39,106-KOCHI,M09073-Mcf Public School,21,108,0,108,0,0,0,0
40,114-DEHRADUN,340124-A.n. Jha Govt. Inter College,22,108,0,108,0,0,0,0
41,109-JAIPUR,170430-Gayatri Sr. Sec. School,22,106,0,106,0,0,0,0
42,107-DELHI,210733-Bal Jagat Sr.Sec. School,17,102,102,0,102,0,95.33,95.33
43,105-CHANDIGARH,M16073-Guru Nanak Convent Sen. Sec. School,18,107,107,0,107,0,100,100
44,107-DELHI,270515-SHAHEED UDHAM SINGH SAMARAK CO-ED SEC. SCHOOL,21,107,104,3,0,104,97.2,0
45,113-BHOPAL,M10091-Maulana Azad Inst. Of Professional,19,107,0,107,0,0,0,0
46,101-HYDERABAD,"370109-T.s.w.r.school Jr.college(g),",19,107,0,107,0,0,0,0
47,109-JAIPUR,170398-Bhairav Public Sr. Sec. School,21,107,77,30,13,64,71.96,12.15
48,114-DEHRADUN,340227-Govt. Inter College,21,105,95,10,95,0,89.62,89.62
49,106-KOCHI,400062-Vimla Hridya Icse School,20,106,0,106,0,0,0,0
50,108-ABROAD/NIOS HQ,950028-Kuwait Educational Centre,25,106,0,106,0,0,0,0
51,118-GANDHINAGAR,390108-P R Mukhi Sec. & Hr. Sec. School,21,106,106,0,72,34,100,67.92
52,111-ALLAHABAD/PRAYAGRAJ,M38273-National Public Inter College,12,106,0,106,0,0,0,0
53,104-GUWAHATI,120023-Sentinel College,21,106,105,1,72,33,99.06,67.92
54,109-JAIPUR,170330-Vivekanand Senior Secondary School,23,106,106,0,0,106,100,0
55,104-GUWAHATI,300001-Madonna Education Centre,23,106,79,27,20,59,74.53,18.87
56,109-JAIPUR,170050-Saraswati Bal Higher Sec. School,21,106,106,0,106,0,100,100
57,121-CHENNAI,190027-The Vikasa School,20,105,88,17,18,70,83.81,17.14
58,114-DEHRADUN,340286-Aryan Vidya Mandir,24,104,0,104,0,0,0,0
59,123-GANGTOK,180009-Govt. Senior Secondary School,23,104,104,0,96,8,100,92.31
60,107-DELHI,270490-Hansraj Model School,20,104,0,104,0,0,0,0
61,118-GANDHINAGAR,390119-Shree Aditya Secondary & High School,17,104,104,0,66,38,100,63.46
62,106-KOCHI,400046-Kendriya Vidyalaya No-1,21,104,77,27,27,50,74.04,25.96
63,107-DELHI,270417-Navyug Convent School,21,104,104,0,104,0,100,100
64,106-KOCHI,"400001-Progressive English School,",20,103,0,103,0,0,0,0
65,105-CHANDIGARH,160120-NRI Public School,18,103,31,72,28,3,30.1,27.18
66,120-RANCHI,260042-Subhash Public School,20,103,99,4,0,99,96.12,0
67,105-CHANDIGARH,160108-Fortune Convent Sr. Sec. School,22,103,40,63,0,40,38.83,0
68,114-DEHRADUN,340257-Govt. Inter College,21,103,0,103,0,0,0,0
69,105-CHANDIGARH,050662-Indus Public School,22,103,103,0,51,52,100,49.51
70,106-KOCHI,400028-Sree Valluvanad Vidya Bhavan,19,102,0,102,0,0,0,0
71,107-DELHI,050212-Bhartiya Vidya Niketan Sr.s.school,23,102,0,102,0,0,0,0
72,125-JAMMU,070054-Prashant Public High School,23,102,95,7,81,14,93.14,79.41
73,118-GANDHINAGAR,390127-Adwait Vidyamandir Jasara,18,102,102,0,90,12,100,88.24
74,102-PUNE,110077-Sri Ma Vidyalaya Patilpada,32,101,90,11,9,81,88.24,8.82
75,109-JAIPUR,170086-Adarsh Jyoti Vidya Peeth,23,101,101,0,85,16,100,84.16
76,109-JAIPUR,170438-Shri Ravinder Nath Tagore Sr. Sec. School,23,101,101,0,57,44,100,56.44
77,118-GANDHINAGAR,040007-Tree House High School,21,101,101,0,57,44,100,56.44
78,106-KOCHI,M40055-M.t.i Central School Pottachira,17,100,48,52,0,48,48,0
79,109-JAIPUR,170397-Lo.Ti. Sr.Sec. School,15,100,0,100,0,0,0,0
80,105-CHANDIGARH,050440-K.n.senior Secondary School,21,100,100,0,100,0,100,100
81,114-DEHRADUN,M34252-Jamia Islahul Banaat,16,100,0,100,0,0,0,0
82,107-DELHI,270525-G R M Public School,18,100,0,100,0,0,0,0
83,105-CHANDIGARH,160141-Shri Deshmesh Public Sr.Sec.School,17,100,89,11,10,79,89,10
84,104-GUWAHATI,M02063-Durabandhi Secondary School,25,100,100,0,98,2,100,98
85,114-DEHRADUN,210804-Paramount Public School,20,100,88,12,64,24,88,64
86,111-ALLAHABAD/PRAYAGRAJ,M21474-Shuaib Mohammedia Anglo Oriental,26,100,49,51,8,41,49,8
87,103-KOLKATA,220127-Pearl Rosary School (New),20,100,71,29,17,54,71,17
88,114-DEHRADUN,M34255-RAMSAY INTER COLLEGE,20,96,83,13,77,6,83,77
89,114-DEHRADUN,340069-Kendriya Vidyalaya,19,99,99,0,99,0,100,100
90,106-KOCHI,090087-Raja Rajeswari Senior Sec.school,17,99,0,99,0,0,0,0
91,104-GUWAHATI,300019-Govt. Higher Secondary School,22,99,37,62,19,18,37.37,19.19
92,105-CHANDIGARH,J05004-District Jail,19,99,0,99,0,0,0,0
93,109-JAIPUR,170167-Govt. Higher Secondary School,20,98,0,98,0,0,0,0
94,125-JAMMU,070055-Shishu Niketan Sr. Sec. School,17,98,0,98,0,0,0,0
95,107-DELHI,270546-N L Public School,21,98,98,0,98,0,100,100
96,125-JAMMU,380108-Govt. Boys Higher Secondary School,21,98,98,0,91,7,100,92.86
97,107-DELHI,210671-Konark Public School,21,98,0,98,0,0,0,0
98,114-DEHRADUN,210672-Dev Krishna Public School,19,97,64,33,56,8,65.98,57.73
99,111-ALLAHABAD/PRAYAGRAJ,210380-Bal Niketan Balika Inter College,18,97,0,97,0,0,0,0
100,118-GANDHINAGAR,"040013-Seth C.l. Hindi High School,",25,97,97,0,80,17,100,82.47
1,107-DELHI,210649-S.b.n. Public School,17,97,0,97,0,0,0,0
2,107-DELHI,270260-Sant Hari Dass Public School,23,97,1,96,0,1,1.03,0
3,120-RANCHI,260086-Jawahar Navodaya Vidyalaya,20,97,0,97,0,0,0,0
4,115-BHUBANESWAR,T15010-Centurian Private ITI,48,97,97,0,76,21,100,78.35
5,106-KOCHI,M40010-Ansar English School,17,97,0,97,0,0,0,0
6,118-GANDHINAGAR,040076-Shree V M Chandera Secondary and Higher Sec. School,10,97,97,0,70,27,100,72.16
7,106-KOCHI,400045-Vyas Vidyaniketan Central School,19,96,96,0,95,1,98.97,97.94
8,106-KOCHI,400019-Mahatma Gandhi Public School,14,97,97,0,0,97,100,0
9,121-CHENNAI,190109-Maharishi Vidya Mandir Senior,31,92,0,92,0,0,0,0
10,114-DEHRADUN,210438-Tagore Vidya Peeth Inter College,20,96,96,0,96,0,100,100
11,107-DELHI,270503-GYAN SAROVER SEC. BAL VIDYALAYA,21,96,96,0,0,96,100,0
12,106-KOCHI,M40063-Mao Higher Secondary School Elayur,27,96,96,0,96,0,100,100
13,103-KOLKATA,220048-Kendriya Vidyalaya No. 2,22,96,0,96,0,0,0,0
14,109-JAIPUR,170358-Kids Club School,23,96,78,18,48,30,81.25,50
15,109-JAIPUR,M17262-Khawaja Model School,18,96,3,93,0,3,3.13,0
16,118-GANDHINAGAR,M04016-St. Xavier's High School,21,96,96,0,65,31,100,67.71
17,114-DEHRADUN,340303-North Point Children's Academy,19,95,0,95,0,0,0,0
18,114-DEHRADUN,340298-Adarsh Inter College,20,95,0,95,0,0,0,0
19,125-JAMMU,070002-Kendriya Vidyalaya No.1,23,95,19,76,0,19,20,0
20,105-CHANDIGARH,050381-Sunshine Public School,18,95,0,95,0,0,0,0
21,106-KOCHI,400043-Kendriya Vidyalaya No-2,19,95,34,61,0,34,35.79,0
22,110-PATNA,030276-Patna High School +2,15,90,1,89,0,1,1.06,0
23,107-DELHI,270324-EKTA MODEL SECONDARY SCHOOL,16,94,0,94,0,0,0,0
24,107-DELHI,270460-New Sandhya Public School,19,94,73,21,0,73,77.66,0
25,119-RAIPUR,290094-Govt. Boys Higher Secondary School,18,94,64,30,8,56,68.09,8.51
26,111-ALLAHABAD/PRAYAGRAJ,210668-Identity Educational Academy,13,94,0,94,0,0,0,0
27,105-CHANDIGARH,160137-Paragon Sr. Sec. School,20,89,39,50,0,39,41.49,0
28,103-KOLKATA,220017-Shree Jain Shilpa Shiksha Kendra,18,94,9,85,9,0,9.57,9.57
29,111-ALLAHABAD/PRAYAGRAJ,210172-Gayatri Samarak Public School,17,93,88,5,88,0,94.62,94.62
30,117-BENGALURU,080071-Patel Pre-University College,19,93,8,85,0,8,8.6,0
31,109-JAIPUR,"170200-Govt. Hr. Sec. School, Chittorgarh",18,93,1,92,0,1,1.08,0
32,106-KOCHI,400041-Kendriya Vidyalaya,21,93,0,93,0,0,0,0
33,105-CHANDIGARH,050480-Saraswati High School,20,92,87,5,87,0,94.57,94.57
34,125-JAMMU,070015-Govt. Boys Higher Secondary School,19,92,92,0,92,0,100,100
35,106-KOCHI,M40068-Infant Jesus Residential School,17,92,0,92,0,0,0,0
36,111-ALLAHABAD/PRAYAGRAJ,210658-Kalawati Inter College,23,92,86,6,18,68,93.48,19.57
37,109-JAIPUR,M38350-Al Suffah Academy Public School,23,92,0,92,0,0,0,0
38,114-DEHRADUN,340087-Maharishi Vidya Mandir,19,90,0,90,0,0,0,0
39,121-CHENNAI,190104-Lalaji Memorial Omega International,39,82,76,6,40,36,83.52,43.96
40,106-KOCHI,090100-Siddartha Central School,15,91,33,58,17,16,36.26,18.68
41,107-DELHI,270242-M.n.convent Sr.sec.school,17,91,0,91,0,0,0,0
42,117-BENGALURU,080075-Sindhi High School,19,90,89,1,20,69,97.8,21.98
43,105-CHANDIGARH,M05113-G.t.b. Bal Vidya Mandir Sr.s.school,18,91,91,0,71,20,100,78.02
44,123-GANGTOK,450043-Raphael Academic & Voc. School,17,90,36,54,0,36,40,0
45,109-JAIPUR,170082-Lal Bahadur Shastri Sr.sec School,8,90,90,0,90,0,100,100
46,109-JAIPUR,170160-Gcm Govt. Hr. Sec. School,17,90,61,29,0,61,67.78,0
47,106-KOCHI,400049-Kendriya Vidyalaya,17,90,82,8,0,82,91.11,0
48,114-DEHRADUN,340219-Ashu Public Inter College,19,90,90,0,0,90,100,0
49,118-GANDHINAGAR,040001-St.xavier's Social Service Society,19,87,86,1,51,35,95.56,56.67
50,120-RANCHI,260074-Dav Public School,19,90,0,90,0,0,0,0
51,103-KOLKATA,220033-Kendriya Vidyalaya,23,89,89,0,55,34,100,61.8
52,125-JAMMU,070008-Govt. Girls Higher Secondary School,18,89,1,88,0,1,1.12,0
53,106-KOCHI,M40034-Crescent Rsidential Higher,20,89,0,89,0,0,0,0
54,106-KOCHI,M40031-Mar Ivonios Bethany School,16,89,0,89,0,0,0,0
55,115-BHUBANESWAR,410148-Name 5103,16,89,89,0,68,21,100,76.4
56,104-GUWAHATI,020024-Kendriya Vidyalaya,21,89,89,0,89,0,100,100
57,107-DELHI,210203-Swami Vivekanandsaraswatividyalaya,16,87,73,14,26,47,82.02,29.21
58,105-CHANDIGARH,050551-Thukral Public Sr. Sec. School ,18,89,89,0,74,15,100,83.15
59,107-DELHI,M21209-Azad Memorial Inter College,18,89,0,89,0,0,0,0
60,114-DEHRADUN,M21354-Ahmed Saeed Khan Rifahe Aam Inter,20,89,89,0,64,25,100,71.91
61,118-GANDHINAGAR,040058-Nib School Of Science,17,89,89,0,63,26,100,70.79
62,115-BHUBANESWAR,150194-Centurian University Of Technology,13,88,86,2,34,52,97.73,38.64
63,107-DELHI,270423-Aryan International School,14,78,0,78,0,0,0,0
64,102-PUNE,M11129-Reena Mehta College,17,88,88,0,74,14,100,84.09
65,105-CHANDIGARH,050638-Rising Sun Public School,18,88,0,88,0,0,0,0
66,120-RANCHI,260084-Vimla Pandey Memorial Gyan Niketan,17,88,14,74,0,14,15.91,0
67,120-RANCHI,260077-Kerala Public School,14,88,88,0,8,80,100,9.09
68,114-DEHRADUN,210251-Agroha Shiksha Niketan Inter,19,88,0,88,0,0,0,0
69,115-BHUBANESWAR,410140-Jawahar  Navodaya Vidyalaya,21,88,63,25,45,18,71.59,51.14
70,114-DEHRADUN,340212-Kendriya Vidyalaya,17,85,0,85,0,0,0,0
71,105-CHANDIGARH,M16112-SOHRAB PUBLIC SCHOOL ,16,87,0,87,0,0,0,0
72,107-DELHI,"J05281-District Jail, Faridabad",21,87,0,87,0,0,0,0
73,125-JAMMU,380266-Srinagar Group of Schools,19,86,0,86,0,0,0,0
74,110-PATNA,030071-S.n.singh Dev. N.g.,18,85,5,80,4,1,5.88,4.71
75,106-KOCHI,400039-Kendriya Vidyalaya,16,85,85,0,31,54,100,36.47
76,105-CHANDIGARH,050387-Rao Jai Ram Sr.sec. School,16,85,0,85,0,0,0,0
77,114-DEHRADUN,"450104-Vaani School And Research Centre,",14,85,85,0,43,42,100,50.59
78,105-CHANDIGARH,050332-Sunrise Modern School,18,85,0,85,0,0,0,0
79,115-BHUBANESWAR,410122-Oriental Public School,14,85,71,14,34,37,83.53,40
80,117-BENGALURU,080027-National Public High School,17,85,0,85,0,0,0,0
81,111-ALLAHABAD/PRAYAGRAJ,210316-Maa Shri Mahakali Inter College,21,85,0,85,0,0,0,0
82,114-DEHRADUN,340142-M.d. Inter College,17,84,0,84,0,0,0,0
83,103-KOLKATA,460288-Lakhuria High School,17,84,0,84,0,0,0,0
84,102-PUNE,110085-Dr.kalmadi Shamarao High School,20,84,79,5,30,49,94.05,35.71
85,107-DELHI,270517-M R BhartiModel Sr. Secondary School,13,83,45,38,0,45,54.22,0
86,105-CHANDIGARH,050654-Satluj Public School,18,83,78,5,78,0,93.98,93.98
87,122-DHARAMSALA,060062-Govt.sr.sec.school,10,83,0,83,0,0,0,0
88,113-BHOPAL,100196-Abhyuday Sr. Sec. School,19,83,65,18,64,1,78.31,77.11
89,107-DELHI,210334-ROCKWOOD SCHOOL,19,83,79,4,43,36,95.18,51.81
90,108-ABROAD/NIOS HQ,970002-Shantiniketan Indian School,18,82,82,0,77,5,100,93.9
91,103-KOLKATA,230001-Govt. Model Sr. Sec. School,13,82,0,82,0,0,0,0
92,121-CHENNAI,190116-Lakshmi Garden Matric Hr.Sec.School,16,82,75,7,46,29,91.46,56.1
93,114-DEHRADUN,210280-Mansarover Girls Inter College,21,82,45,37,0,45,54.88,0
94,103-KOLKATA,220100-Kankinara Himayatul Ghurba,15,81,78,3,76,2,96.3,93.83
95,105-CHANDIGARH,M05090-Ilyas Public School,21,81,0,81,0,0,0,0
96,107-DELHI,270219-Kendriya Vidylaya,18,80,0,80,0,0,0,0
97,107-DELHI,050221-VIVEK VIDYA SADAN SR.SEC SCHOOL,17,81,0,81,0,0,0,0
98,110-PATNA,030368-Jawahar Navodaya Vidyalaya,15,81,81,0,0,81,100,0
99,107-DELHI,210716-Milton Academy Jr. High School,15,81,0,81,0,0,0,0
100,107-DELHI,450019-Amar Jyoti Rehablitation & Research,20,81,0,81,0,0,0,0
1,107-DELHI,270534-R M Arya Girls Sr. Secondary School,17,81,0,81,0,0,0,0
2,104-GUWAHATI,130008-Mizo Modern High School,16,81,28,53,4,24,34.57,4.94
3,115-BHUBANESWAR,410138-410138-BRAJENDRA HIGH SCHOOL,17,81,62,19,39,23,76.54,48.15
4,103-KOLKATA,220124-Durgapur Iswar Chandra Vidyasagar (DICV) Public School,17,79,48,31,1,47,60,1.25
5,105-CHANDIGARH,160036-Suman Dav-boarding Public School,16,80,9,71,0,9,11.25,0
6,108-ABROAD/NIOS HQ,910001-International Indian School,16,80,80,0,11,69,100,13.75
7,121-CHENNAI,190156-DAV Boys Sr. Secondary School,20,80,80,0,69,11,100,86.25
8,103-KOLKATA,220122-Aaloke Bharti Model School,16,79,0,79,0,0,0,0
9,107-DELHI,450072-Prayas Juvenile Aid Centre,17,79,0,79,0,0,0,0
10,105-CHANDIGARH,050570-SHRI KRISHAN PUBLIC SCHOOL,18,79,79,0,43,36,100,54.43
11,114-DEHRADUN,340202-Government Inter College,17,79,0,79,0,0,0,0
12,110-PATNA,030074-Zila School,15,79,10,69,8,2,12.66,10.13
13,114-DEHRADUN,340198-Govt. Inter College damta,19,79,79,0,79,0,100,100
14,107-DELHI,270465-R.P. Memorial Public Sr.Sec.School,15,69,9,60,0,9,11.39,0
15,102-PUNE,110073-Symbiosis,19,68,63,5,7,56,80.77,8.97
16,114-DEHRADUN,340169-Saigrace Academy International,16,74,0,74,0,0,0,0
17,121-CHENNAI,190127-B.V.M. Global,16,78,71,7,43,28,91.03,55.13
18,104-GUWAHATI,130014-Kendriya Vidyalaya,15,76,76,0,24,52,97.44,30.77
19,114-DEHRADUN,M38366-Mesco Public School,19,78,78,0,78,0,100,100
20,106-KOCHI,"400018-Darussalam English School,",14,78,0,78,0,0,0,0
21,106-KOCHI,M09100-MGM CENTRAL SCHOOL,14,77,0,77,0,0,0,0
22,109-JAIPUR,170318-Sant Vidya Nand Sr.sec.sch.& Hostel,17,77,17,60,0,17,22.08,0
23,110-PATNA,"030329-Rajkiya +2 High School,",14,72,5,67,4,1,6.49,5.19
24,103-KOLKATA,230007-Govt. Senior Secondary School,13,76,68,8,62,6,88.31,80.52
25,105-CHANDIGARH,160066-Pine Grove Public School,15,77,13,64,0,13,16.88,0
26,107-DELHI,270310-Bharat Shakti Public School,13,77,48,29,0,48,62.34,0
27,110-PATNA,M03114-Red Carpet High School,14,77,0,77,0,0,0,0
28,114-DEHRADUN,340294-Guru Nanak Mission Public School,18,77,58,19,57,1,75.32,74.03
29,109-JAIPUR,170301-Ramnivas Vidya Mandir Sr.sec.school,15,76,76,0,76,0,100,100
30,104-GUWAHATI,M30011-Sacred Heart School,15,76,9,67,4,5,11.84,5.26
31,109-JAIPUR,170413-Saraswati Vidya Mandir Sr. Sec. School,15,76,76,0,56,20,100,73.68
32,105-CHANDIGARH,050442-Golden Crescent Public School,17,76,1,75,0,1,1.32,0
33,104-GUWAHATI,020065-KENDRIYA VIDYALAYA,15,76,34,42,12,22,44.74,15.79
34,107-DELHI,270425-Mount Abu Public School,16,75,75,0,73,2,100,97.33
35,107-DELHI,050190-S.d.modern Sr.sec.school,15,75,0,75,0,0,0,0
36,109-JAIPUR,170303-Sethi Sr.sec.school,13,75,0,75,0,0,0,0
37,107-DELHI,210715-J.P. International School,14,75,0,75,0,0,0,0
38,118-GANDHINAGAR,040095-Maharshi Vidhyalaya,13,75,75,0,48,27,100,64
39,106-KOCHI,"400023-Labour India Public School,",17,75,14,61,14,0,18.67,18.67
40,107-DELHI,270122-PUSA PUBLIC SR.SEC.SCHOOL,14,75,51,24,51,0,68,68
41,102-PUNE,M11018-Guru Govind Singh Public School,15,75,75,0,44,31,100,58.67
42,103-KOLKATA,450028-M.k.r.&r.indtit For The Handicapped,15,73,50,23,0,50,66.67,0
43,111-ALLAHABAD/PRAYAGRAJ,210479-Shri Sovaran Singh Ratani Devi,19,75,75,0,0,75,100,0
44,107-DELHI,270554-G R International School,18,74,33,41,0,33,44.59,0
45,106-KOCHI,090069-Jawahar Navodaya Vidyalaya,11,74,0,74,0,0,0,0
46,121-CHENNAI,190107-KH MATRICULATION BOYS HR. SEC. SCHOOL`,16,74,74,0,31,43,100,41.89
47,118-GANDHINAGAR,040017-Gracious English School,13,74,74,0,70,4,100,94.59
48,106-KOCHI,M40036-Mar Dionysius Sr.sec.school,16,74,0,74,0,0,0,0
49,118-GANDHINAGAR,390120-Maharshi Vidhyalaya,14,74,74,0,50,24,100,67.57
50,121-CHENNAI,190125-Blossom Public School,15,74,71,3,0,71,95.95,0
51,123-GANGTOK,180001-Govt. Senior Secondary School,15,72,47,25,3,44,63.51,4.05
52,114-DEHRADUN,210246-R.s.d. Academy Public School,15,74,74,0,74,0,100,100
53,118-GANDHINAGAR,390087-Janki Vidyalaya,20,73,73,0,55,18,100,75.34
54,114-DEHRADUN,340167-Sanjay Public Intermediate College,11,73,0,73,0,0,0,0
55,107-DELHI,270407-Modern New Delhi Public School,14,73,1,72,0,1,1.37,0
56,105-CHANDIGARH,250013-Aanchal International School,19,73,0,73,0,0,0,0
57,105-CHANDIGARH,160016-Rabindra Day Boarding Ss.pub.school,15,73,0,73,0,0,0,0
58,115-BHUBANESWAR,410146-Chitalo Mohavidyalaya,14,73,46,27,31,15,63.01,42.47
59,105-CHANDIGARH,160159-Dashmesh Sr. Sec. School,15,73,49,24,0,49,67.12,0
60,104-GUWAHATI,029001-Model Study Centre,13,66,22,44,2,20,30.14,2.74
61,107-DELHI,210289-C.c.s Vidya Mandir Girl's,14,73,73,0,32,41,100,43.84
62,109-JAIPUR,170240-Govind Vidya Mandir Hr.sec. School,12,73,0,73,0,0,0,0
63,109-JAIPUR,170276-Shri Bhagwati Vaidya Mandir,13,72,72,0,72,0,100,100
64,110-PATNA,"030249-V.m. Inter College,",13,72,0,72,0,0,0,0
65,115-BHUBANESWAR,J15165-Spl. Jail Bhubaneswar,14,72,38,34,38,0,52.78,52.78
66,102-PUNE,110064-The Lord's English High School,17,70,69,1,51,18,97.18,71.83
67,114-DEHRADUN,340111-Govt. Intermediate College,13,70,70,0,0,70,98.59,0
68,104-GUWAHATI,200019-Melagarh H.s.school,13,71,15,56,8,7,21.13,11.27
69,119-RAIPUR,290169-Colonel's Academy of Radiant Education,13,71,71,0,0,71,100,0
70,107-DELHI,050316-S.r. Sr.sec. School,15,71,0,71,0,0,0,0
71,118-GANDHINAGAR,040003-Asoplav Nidhi,14,61,60,1,42,18,84.51,59.15
72,114-DEHRADUN,M38358-Madarsa Islahul Muslimeen,19,71,71,0,0,71,100,0
73,114-DEHRADUN,210208-Muslim Inter College,13,71,2,69,0,2,2.82,0
74,115-BHUBANESWAR,150174-Town High School,11,71,39,32,19,20,54.93,26.76
75,114-DEHRADUN,340177-Tharu Govt. Inter College,13,71,3,68,0,3,4.23,0
76,122-DHARAMSALA,060022-St. Luke's High School,11,71,0,71,0,0,0,0
77,107-DELHI,210096-Saraswati Bal Mandir Sr.sec.school,15,71,0,71,0,0,0,0
78,104-GUWAHATI,"020017-Diphu Commercial College,",14,71,11,60,9,2,15.49,12.68
79,101-HYDERABAD,M47019-Al-Ameen Jr. Degree College,21,70,70,0,8,62,100,11.43
80,114-DEHRADUN,210121-Islamia Inter College,14,70,0,70,0,0,0,0
81,120-RANCHI,260180-+2 High School,13,70,69,1,65,4,98.57,92.86
82,104-GUWAHATI,M38331-Maryam Ajmal Women's College Of,9,70,0,70,0,0,0,0
83,123-GANGTOK,180010-Govt. Senior Secondary School,12,69,0,69,0,0,0,0
84,117-BENGALURU,080003-Don Bosco Academy,15,69,0,69,0,0,0,0
85,107-DELHI,450060-National Association For The Blind,15,69,69,0,69,0,100,100
86,108-ABROAD/NIOS HQ,950012-My Capital Educational Facilities Management Facilities Management,15,69,69,0,69,0,100,100
87,122-DHARAMSALA,060023-Akal Academy,12,69,1,68,0,1,1.45,0
88,114-DEHRADUN,340031-Kendriya Vidyalaya No.1,12,69,0,69,0,0,0,0
89,111-ALLAHABAD/PRAYAGRAJ,210789-Vikas Bharti School,10,69,0,69,0,0,0,0
90,111-ALLAHABAD/PRAYAGRAJ,210540-Shree Mahaprabhu Public School,15,69,69,0,69,0,100,100
91,115-BHUBANESWAR,150195-Suddhananda Vidyalaya,12,67,44,23,20,24,64.71,29.41
92,114-DEHRADUN,340285-Gandhi Inter College,14,68,14,54,2,12,20.59,2.94
93,104-GUWAHATI,020026-Kendriya Vidyalaya,13,56,52,4,9,43,76.47,13.24
94,104-GUWAHATI,020037-Kendriya Vidyalaya,13,68,14,54,10,4,20.59,14.71
95,106-KOCHI,090024-Trinity Lyceum,14,68,0,68,0,0,0,0
96,113-BHOPAL,100239-Alpa Bhashi Higher Secondary School,7,68,0,68,0,0,0,0
97,120-RANCHI,260045-Pvss Dav Public School,14,68,0,68,0,0,0,0
98,120-RANCHI,450032-Manthan Yuva Sangathan,8,68,52,16,52,0,76.47,76.47
99,105-CHANDIGARH,050524-Adarsh Senior Secondary School,14,67,65,2,0,65,97.01,0
100,120-RANCHI,260052-Rabindra Nath Tagore Inter College,12,67,58,9,0,58,86.57,0
1,118-GANDHINAGAR,040005-Queen Of Angels Convent School,10,67,67,0,34,33,100,50.75
2,105-CHANDIGARH,J05282-Central Jail,14,67,0,67,0,0,0,0
3,107-DELHI,270435-Bal Vidya Model School,14,65,63,2,51,12,94.03,76.12
4,107-DELHI,270202-Shiksha Bharti Public School,12,67,0,67,0,0,0,0
5,113-BHOPAL,100076-Akshay Academy Hr. Secondary School,15,66,0,66,0,0,0,0
6,114-DEHRADUN,340170-Rashtriya Inter College,8,66,0,66,0,0,0,0
7,105-CHANDIGARH,050574-INDOLOGY PUBLIC SR. SEC. SCHOOL,11,66,0,66,0,0,0,0
8,107-DELHI,050350-Shanti Niketan Public School,8,66,12,54,0,12,18.18,0
9,116-VISAKHAPATNAM,010175-Sri Sai Baba Junior College,11,66,65,1,59,6,98.48,89.39
10,118-GANDHINAGAR,390118-Ankur Vidhyalaya,13,66,66,0,55,11,100,83.33
11,107-DELHI,270522-Shri Tula Ram Public School,10,66,0,66,0,0,0,0
12,111-ALLAHABAD/PRAYAGRAJ,210030-Kendriya Vidyalaya No.1 AFS Chakeri Kanpur,14,66,0,66,0,0,0,0
13,111-ALLAHABAD/PRAYAGRAJ,210539-Oxford Public School,16,65,0,65,0,0,0,0
14,104-GUWAHATI,300017-Govt. Khawzawl High School,12,65,65,0,0,65,100,0
15,120-RANCHI,260198-Saraswati Vidya Mandir,11,65,0,65,0,0,0,0
16,104-GUWAHATI,440007-Doomdooma Junior College,14,65,24,41,19,5,36.92,29.23
17,120-RANCHI,260032-St. Xaviers High School,13,64,64,0,64,0,100,100
18,103-KOLKATA,220014-Caesar School,13,64,0,64,0,0,0,0
19,111-ALLAHABAD/PRAYAGRAJ,210775-Smart Indian Model School,13,64,0,64,0,0,0,0
20,107-DELHI,270549-D K Convent School,11,64,64,0,0,64,100,0
21,115-BHUBANESWAR,150013-The Assembly Of God School,12,64,48,16,22,26,75,34.38
22,103-KOLKATA,230008-Govt. Senior Secondary School,11,64,40,24,17,23,62.5,26.56
23,107-DELHI,270512-Jagriti Public School,13,64,0,64,0,0,0,0
24,107-DELHI,270535-Little Star Convent School,14,64,2,62,0,2,3.13,0
25,118-GANDHINAGAR,390129-P. Chandra International School,11,64,64,0,38,26,100,59.38
26,105-CHANDIGARH,160074-Aadharshila The Foundation,14,63,0,63,0,0,0,0
27,105-CHANDIGARH,160039-Jamuna Model Sr. Sec. School,14,61,61,0,61,0,96.83,96.83
28,103-KOLKATA,M22097-Chachanda B.j. High School,10,63,63,0,63,0,100,100
29,125-JAMMU,070032-Jawahar Navodaya Vidyalaya,11,63,63,0,23,40,100,36.51
30,121-CHENNAI,310009-Aditya Vidhyashram Residential Sch.,13,63,0,63,0,0,0,0
31,106-KOCHI,400021-T.k.m Higher Sec.school,12,63,39,24,30,9,61.9,47.62
32,107-DELHI,270520-Sevti Devi Memorial Vidya Mandir,14,63,0,63,0,0,0,0
33,104-GUWAHATI,"020047-Kendriya Vidyalaya, Crpf,",13,63,40,23,1,39,63.49,1.59
34,109-JAIPUR,170308-Vivek Vidhya Mandir Sr.sec.school,13,62,0,62,0,0,0,0
35,111-ALLAHABAD/PRAYAGRAJ,210537-Jamuna Prasad Girls Inter College,14,62,43,19,43,0,69.35,69.35
36,110-PATNA,030263-+2 Zila School,12,62,0,62,0,0,0,0
37,111-ALLAHABAD/PRAYAGRAJ,210138-Ajay Girls Inter College,11,61,3,58,0,3,4.92,0
38,107-DELHI,270129-Prerana Public Secondary School,13,61,0,61,0,0,0,0
39,113-BHOPAL,M38346-Madarsa Nascent Diniyat,7,61,61,0,61,0,100,100
40,107-DELHI,210761-NARAYANA PUBLIC SCHOOL,11,61,60,1,15,45,98.36,24.59
41,102-PUNE,110141-Sree Narayana Guru College of Commerce,8,61,2,59,0,2,3.28,0
42,105-CHANDIGARH,160035-F.s. Mann Silver Greek School,13,61,61,0,54,7,100,88.52
43,106-KOCHI,350001-Kendriya Vidyalaya,11,60,7,53,0,7,11.67,0
44,120-RANCHI,260095-Govt. Russel +2 High School,12,60,0,60,0,0,0,0
45,118-GANDHINAGAR,040055-Janki Vidyalaya,11,60,58,2,43,15,96.67,71.67
46,109-JAIPUR,"170253-Kendriya  Vidyalaya No.3,",13,60,49,11,14,35,81.67,23.33
47,110-PATNA,030265-Shersahsuri Ucch Madhyamik,16,60,0,60,0,0,0,0
48,118-GANDHINAGAR,040064-Navrachana school,16,56,56,0,39,17,93.33,65
49,107-DELHI,M27489-Jesus Grace Modern School,7,60,0,60,0,0,0,0
50,109-JAIPUR,170002-New Look Central School,12,60,40,20,0,40,66.67,0
51,106-KOCHI,400042-Kendriya Vidyalaya,10,60,0,60,0,0,0,0
52,114-DEHRADUN,340193-U.s.r. Indu Inter College,10,59,0,59,0,0,0,0
53,104-GUWAHATI,140032-Govt. Higher Secondary school,14,59,6,53,0,6,10.17,0
54,111-ALLAHABAD/PRAYAGRAJ,210723-Army Public School,14,59,2,57,2,0,3.39,3.39
55,106-KOCHI,M40065-Iqra Islamic Women's College,11,59,59,0,36,23,100,61.02
56,102-PUNE,280006-Dr. Sakha Ram Gude High School,11,59,11,48,0,11,18.64,0
57,109-JAIPUR,170275-Supreme Bal Bharti Sr.sec.school,12,59,0,59,0,0,0,0
58,117-BENGALURU,080079-M.V.J International School,15,59,0,59,0,0,0,0
59,120-RANCHI,260121-Rajkiya Krit +2 High School,13,59,0,59,0,0,0,0
60,101-HYDERABAD,470072-I.s.o. Jr. College,14,58,1,57,1,0,1.72,1.72
61,125-JAMMU,070039-Jawahar Navodaya Vidyalaya,12,58,0,58,0,0,0,0
62,104-GUWAHATI,200021-Chandraipara H.s.school,10,58,19,39,6,13,32.76,10.34
63,114-DEHRADUN,M34238-Shri Guru Nanak Academy,12,58,0,58,0,0,0,0
64,111-ALLAHABAD/PRAYAGRAJ,210322-Purvanchal Bal Shramik Madhyasmik,12,58,0,58,0,0,0,0
65,105-CHANDIGARH,050566-KOYAL PUBLIC SR. SEC. SCHOOL,15,58,0,58,0,0,0,0
66,109-JAIPUR,320609-HQ 24 Rapid,12,58,57,1,53,4,98.28,91.38
67,117-BENGALURU,080076-Delhi Public School,13,58,0,58,0,0,0,0
68,123-GANGTOK,180011-Govt. Senior Secondary School,12,58,58,0,47,11,100,81.03
69,118-GANDHINAGAR,040105-Shree Swaminarayan English Medium School,13,58,58,0,22,36,100,37.93
70,107-DELHI,270518-Vasundhara Public School,11,58,58,0,58,0,100,100
71,107-DELHI,270464-M.d. Memorial Sec. Public School,11,57,0,57,0,0,0,0
72,120-RANCHI,260192-Kerala Samajam Model School,11,57,22,35,2,20,38.6,3.51
73,107-DELHI,210650-Bhagirath Public School,9,57,0,57,0,0,0,0
74,102-PUNE,M11132-Kaiser College of Commerce,12,57,0,57,0,0,0,0
75,106-KOCHI,M40072-Al Ameen English School,11,57,0,57,0,0,0,0
76,120-RANCHI,260188-Jasidih Public School,11,55,0,55,0,0,0,0
77,119-RAIPUR,290172-J R DANI GOVT. GR HR. SEC SCHOOL,13,57,0,57,0,0,0,0
78,114-DEHRADUN,M38250-Jamia Tut Tayyibat Niswan College,11,57,48,9,5,43,84.21,8.77
79,105-CHANDIGARH,050613-Sardar Vallabh Bhai Public School,13,57,23,34,14,9,40.35,24.56
80,111-ALLAHABAD/PRAYAGRAJ,210158-St.andrews High School,12,57,32,25,0,32,56.14,0
81,113-BHOPAL,100008-Kendriya Vidyalaya No.1,13,57,0,57,0,0,0,0
82,107-DELHI,210509-New Adarsh Public School,13,57,0,57,0,0,0,0
83,118-GANDHINAGAR,390113-Nand Vidya Niketan,12,55,55,0,37,18,96.49,64.91
84,114-DEHRADUN,340252-Divine Light School,12,56,0,56,0,0,0,0
85,104-GUWAHATI,020028-Kendriya Vidyalaya,11,56,16,40,0,16,28.57,0
86,107-DELHI,210772-Bloom International School,11,51,40,11,4,36,71.43,7.14
87,114-DEHRADUN,340203-Government Inter College,13,56,37,19,19,18,66.07,33.93
88,105-CHANDIGARH,050588-B.V.N. Sr. Sec. School,8,56,0,56,0,0,0,0
89,118-GANDHINAGAR,040048-Adarsh Vidhyalay,12,56,56,0,39,17,100,69.64
90,120-RANCHI,260044-Dav Public School,10,56,0,56,0,0,0,0
91,123-GANGTOK,220055-Auxilium Convent,10,56,54,2,54,0,96.43,96.43
92,102-PUNE,110044-Jai Bharat High School& Jr.college,10,56,17,39,0,17,30.36,0
93,115-BHUBANESWAR,M15042-Syed Saminary High School,9,56,55,1,28,27,98.21,50
94,114-DEHRADUN,340195-Govt. Inter College,13,55,0,55,0,0,0,0
95,105-CHANDIGARH,050438-S.D. Senior Secondary School,11,55,26,29,0,26,47.27,0
96,107-DELHI,270292-T.N.Public School,12,55,49,6,49,0,89.09,89.09
97,102-PUNE,110133-The Chanda Devi Saraf School,11,55,52,3,13,39,94.55,23.64
98,117-BENGALURU,M08026-Bethany High School,13,53,37,16,11,26,67.27,20
99,107-DELHI,210233-National Public Sr.sec.school,9,55,0,55,0,0,0,0
100,107-DELHI,210383-Mahaveer Singh Inter College,13,55,0,55,0,0,0,0
1,106-KOCHI,M40059-Islamic Central School,12,55,0,55,0,0,0,0
2,113-BHOPAL,100302-Siddhi Vinayak Public School,7,55,52,3,0,52,94.55,0
3,114-DEHRADUN,M38344-Madarsa Maulana Abul Kalam Azad,15,55,55,0,0,55,100,0
4,113-BHOPAL,100080-Adarsh Higher Sec.school,11,55,0,55,0,0,0,0
5,107-DELHI,270432-Delhi Convent School,10,55,0,55,0,0,0,0
6,109-JAIPUR,170134-Sanskar Shikshan Sansthan,10,54,54,0,23,31,100,42.59
7,105-CHANDIGARH,160027-Shining Stars Senior Sec. School,12,54,54,0,25,29,100,46.3
8,102-PUNE,110055-Divine Provident High School & Jr. College,12,54,50,4,48,2,92.59,88.89
9,120-RANCHI,260122-J.b.c. +2 School,10,54,0,54,0,0,0,0
10,117-BENGALURU,M08058-SILICON CITY PUBLIC SCHOOL,12,54,48,6,0,48,88.89,0
11,103-KOLKATA,460520-Khanyadihi High School,12,54,31,23,0,31,57.41,0
12,109-JAIPUR,170386-AVS School,13,54,0,54,0,0,0,0
13,107-DELHI,270177-Gagan Bharti Public School,12,53,0,53,0,0,0,0
14,105-CHANDIGARH,050117-Shivalik Senior Secondary School,14,53,0,53,0,0,0,0
15,107-DELHI,M38365-New Horizon School,11,53,27,26,13,14,50.94,24.53
16,114-DEHRADUN,M38216-Islamia Inter Collere,14,53,0,53,0,0,0,0
17,114-DEHRADUN,210317-St. Francis School,10,53,2,51,0,2,3.77,0
18,120-RANCHI,M26082-Loyala School,11,53,53,0,53,0,100,100
19,111-ALLAHABAD/PRAYAGRAJ,210132-Zakir Hussain Model Sr.sec.school,11,52,0,52,0,0,0,0
20,121-CHENNAI,190041-Riverside Public School,15,49,0,49,0,0,0,0
21,105-CHANDIGARH,160049-Tagore Public School,12,52,48,4,45,3,92.31,86.54
22,105-CHANDIGARH,250015-THE BRITISH SCHOOL,10,52,0,52,0,0,0,0
23,106-KOCHI,M40035-Darul Hikam Residential School,9,52,0,52,0,0,0,0
24,105-CHANDIGARH,"160071-B.c.m.arya Model Sr.sec.school,",12,51,19,32,19,0,36.54,36.54
25,102-PUNE,"M38037-Shoeb High School & Jr College,",9,52,0,52,0,0,0,0
26,105-CHANDIGARH,"050259-Vidya Bharti Sr.sec.school,",12,52,48,4,1,47,92.31,1.92
27,105-CHANDIGARH,050224-Harsh Public Sr.sec.school,6,51,0,51,0,0,0,0
28,109-JAIPUR,170383-New Rajasthan Public Sr.Sec.School,10,51,0,51,0,0,0,0
29,115-BHUBANESWAR,410134-410134-BARRKS HIGH SCHOOL,16,51,33,18,17,16,64.71,33.33
30,105-CHANDIGARH,160170-New Model Sr. Sec. School,12,51,8,43,0,8,15.69,0
31,107-DELHI,050122-M.D. High School,11,51,0,51,0,0,0,0
32,109-JAIPUR,M17074-Baba Har Singh Bedi Memorial,11,51,0,51,0,0,0,0
33,105-CHANDIGARH,050150-Arya Sr. Sec. School,11,51,0,51,0,0,0,0
34,105-CHANDIGARH,160069-K.K.MAHAJAN A.V.M. Sr.Sec SCHOOL,10,51,44,7,21,23,86.27,41.18
35,109-JAIPUR,320612-HRDC HQ 16 INF Div,14,51,44,7,0,44,86.27,0
36,117-BENGALURU,080031-Kendriya Vidyalaya,13,50,0,50,0,0,0,0
37,109-JAIPUR,170249-Adarsh Ucch Madhyamik Bal Vidyalaya,11,50,47,3,39,8,92.16,76.47
38,109-JAIPUR,170313-Nav Nirman Bal Niketan Sec.school,13,51,41,10,0,41,80.39,0
39,107-DELHI,210801-Paras Public School,10,51,0,51,0,0,0,0
40,121-CHENNAI,190108-Mahatma Montessori School,18,51,44,7,31,13,86.27,60.78
41,109-JAIPUR,170425-Shaheed Kansingh Memorial Shikshan Sansthan Senior Secondary School,9,50,50,0,11,39,100,22
42,111-ALLAHABAD/PRAYAGRAJ,M21546-National Public Inter College,8,50,0,50,0,0,0,0
43,111-ALLAHABAD/PRAYAGRAJ,210730-Kendriya Vidyalaya No.2,15,50,42,8,41,1,84,82
44,111-ALLAHABAD/PRAYAGRAJ,210043-Allahabad Gram Vikas Samiti,12,50,0,50,0,0,0,0
45,114-DEHRADUN,340187-Jawahar Navodaya Vidyalaya,12,50,0,50,0,0,0,0
46,107-DELHI,270347-Shishu Niketan Public School,9,50,44,6,21,23,88,42
47,117-BENGALURU,080078-BGS National Public School,11,50,0,50,0,0,0,0
48,114-DEHRADUN,340105-Govt. Inter College,9,50,0,50,0,0,0,0
49,107-DELHI,270404-Shanti Gyan International,9,49,0,49,0,0,0,0
50,121-CHENNAI,190111-The Trinity Academy,10,50,6,44,0,6,12,0
51,114-DEHRADUN,210175-Dayanand Saraswati Inter College,13,50,0,50,0,0,0,0
52,121-CHENNAI,M38322-Crescent Matric Hr.sec. School,9,49,49,0,49,0,98,98
53,113-BHOPAL,J10208-District Jail,8,49,0,49,0,0,0,0
54,109-JAIPUR,170237-Kiran Bal Bharti Sr.sec. School,10,49,26,23,24,2,53.06,48.98
55,105-CHANDIGARH,050516-Galaxy International School,6,49,44,5,0,44,89.8,0
56,114-DEHRADUN,340271-Govt. Inter College,8,49,0,49,0,0,0,0
57,109-JAIPUR,170291-Shri Ram Public Sr. Sec. School,10,49,0,49,0,0,0,0
58,111-ALLAHABAD/PRAYAGRAJ,210044-Aminabad Inter College,15,49,0,49,0,0,0,0
59,114-DEHRADUN,M34237-Madarsa Garib Nawaz,10,49,0,49,0,0,0,0
60,117-BENGALURU,M08059-SERA JE SECONDARY SCHOOL,9,49,14,35,0,14,28.57,0
61,105-CHANDIGARH,160115-Anne's School,12,39,27,12,0,27,55.1,0
62,105-CHANDIGARH,M16105-Almighty Public School,11,49,0,49,0,0,0,0
63,102-PUNE,110011-Holy Cross Convent High School,8,44,0,44,0,0,0,0
64,104-GUWAHATI,020051-Jawahar Navodaya Vidyalaya,10,49,11,38,0,11,22.45,0
65,102-PUNE,"M11086-Lady Khatun Marium School,",9,48,46,2,8,38,95.83,16.67
66,102-PUNE,110033-Shoeb High School & Jr.college,10,48,48,0,48,0,100,100
67,107-DELHI,270397-Govt. Boys Senior Secondary School,10,48,0,48,0,0,0,0
68,104-GUWAHATI,120046-The Little Angel's English School,12,48,14,34,0,14,29.17,0
69,120-RANCHI,260108-S.s. +2 High School,10,48,0,48,0,0,0,0
70,118-GANDHINAGAR,390156-Shri Vidhyatirth Madhyamik and Ucchatar Madhyamik Shala,6,48,48,0,33,15,100,68.75
71,114-DEHRADUN,340185-Will Field School,12,48,48,0,6,42,100,12.5
72,110-PATNA,030150-Rajkiyakrit Rajput Ucch Vidyalaya,9,48,4,44,4,0,8.33,8.33
73,103-KOLKATA,220113-Devaki Memorial School,10,48,48,0,48,0,100,100
74,114-DEHRADUN,M21647-Madrasa Jamiatus Salihat Girls,9,48,0,48,0,0,0,0
75,106-KOCHI,090093-Rani Public School,11,48,48,0,48,0,100,100
76,111-ALLAHABAD/PRAYAGRAJ,210313-Lord Mahakaleshwar Inter College,10,48,48,0,48,0,100,100
77,113-BHOPAL,100044-Raghuvansh Higher Sec. School,11,47,41,6,0,41,87.23,0
78,113-BHOPAL,"100075-Vikram Higher Secondary School,",10,47,8,39,0,8,17.02,0
79,104-GUWAHATI,020008-Carmel Trng. Cen.of Donbosco School,9,47,37,10,10,27,78.72,21.28
80,103-KOLKATA,460526-Durgapur Iswar Chandra Vidyasagar (DICV) Public School,10,47,35,12,8,27,74.47,17.02
81,113-BHOPAL,100313-Shri Ravendra Singh Saraswati Hr. Sec. School,5,47,47,0,20,27,100,42.55
82,114-DEHRADUN,340324-Persistent Students Nest Higher Secondary School,10,47,47,0,39,8,100,82.98
83,106-KOCHI,M40071-Gods Own Public School,8,46,46,0,42,4,100,91.3
84,107-DELHI,M27479-Khadijatul Kubra Girls Public Sch.,11,46,42,4,0,42,91.3,0
85,121-CHENNAI,190081-Govt. Hr. Sec. School,11,46,0,46,0,0,0,0
86,111-ALLAHABAD/PRAYAGRAJ,210596-M.G. Convent School,12,46,0,46,0,0,0,0
87,104-GUWAHATI,020057-Kendriya Vidyalaya,9,46,9,37,5,4,19.57,10.87
88,107-DELHI,210366-Kendriya Vidyalaya,9,46,0,46,0,0,0,0
89,111-ALLAHABAD/PRAYAGRAJ,210513-Maya Devi Higher Secondary School,8,46,0,46,0,0,0,0
90,121-CHENNAI,190098-Sri Seshaas Public School,15,46,0,46,0,0,0,0
91,105-CHANDIGARH,M38014-Ilyas Public School,11,46,0,46,0,0,0,0
92,103-KOLKATA,M38140-Belgachia Urdu High School,11,46,0,46,0,0,0,0
93,123-GANGTOK,460531-North Bengal Central School,9,46,41,5,13,28,89.13,28.26
94,110-PATNA,"030314-Sitamarhi Inter +2 College,",8,41,33,8,0,33,71.74,0
95,125-JAMMU,M07049-Muslim Institute Of Education,9,45,1,44,0,1,2.22,0
96,118-GANDHINAGAR,390158-Rasiklal Nathulal Shah (Rangwala) Secondary & Higher Secondary School,8,45,45,0,35,10,100,77.78
97,107-DELHI,270504-Yuvashakti Model School,11,45,27,18,0,27,60,0
98,106-KOCHI,400050-Kendriya Vidyalaya,8,45,0,45,0,0,0,0
99,125-JAMMU,M07048-Greenway Public School,7,45,0,45,0,0,0,0
100,111-ALLAHABAD/PRAYAGRAJ,210324-Maharishi Arvind Shikshan Sansthan,8,44,13,31,0,13,28.89,0
1,109-JAIPUR,170417-Adarsh Bal Niketan Sr. Sec. School,9,45,45,0,45,0,100,100
2,105-CHANDIGARH,050096-Shri Ram Sr. Sec. School,6,45,0,45,0,0,0,0
3,118-GANDHINAGAR,040045-Saraswat International Academy,9,45,45,0,27,18,100,60
4,102-PUNE,110006-St.joseph's Convent Girls H.school,17,45,20,25,10,10,44.44,22.22
5,118-GANDHINAGAR,040033-Bright High School,7,43,43,0,15,28,95.56,33.33
6,121-CHENNAI,M42001-Kh Matriculation Boys Hr.sec.school,9,45,44,1,4,40,97.78,8.89
7,110-PATNA,030073-Rashtiya Ucch Vidyalaya,10,45,37,8,37,0,82.22,82.22
8,118-GANDHINAGAR,390075-K.r. Doshi High School,10,45,45,0,45,0,100,100
9,107-DELHI,210035-Kendriya Vidyalaya No.1,12,45,0,45,0,0,0,0
10,110-PATNA,M38224-Khalikum  Nisha Sajjad Millat,6,44,0,44,0,0,0,0
11,111-ALLAHABAD/PRAYAGRAJ,210131-St. H.N. Public Inter College,8,44,0,44,0,0,0,0
12,121-CHENNAI,190062-Govt. Boys Higher Secondary School,12,44,0,44,0,0,0,0
13,114-DEHRADUN,340205-Govt. Pratap Inter College,11,44,0,44,0,0,0,0
14,117-BENGALURU,M08060-Orchids The International School,9,44,9,35,1,8,20.45,2.27
15,104-GUWAHATI,440009-Sree Narasinghasthan High School,8,44,25,19,19,6,56.82,43.18
16,121-CHENNAI,M19042-Montfort Matric Hr.sec. School,18,44,0,44,0,0,0,0
17,105-CHANDIGARH,160013-D.r.modern Sr. Sec.school,8,44,0,44,0,0,0,0
18,109-JAIPUR,170137-A.n. Public School,10,44,38,6,36,2,86.36,81.82
19,111-ALLAHABAD/PRAYAGRAJ,210741-Florets International School,8,39,0,39,0,0,0,0
20,118-GANDHINAGAR,040103-L D R International School,10,43,41,2,27,14,95.35,62.79
21,109-JAIPUR,170395-Swami Shree Niwas Acharya Shikshan,9,43,27,16,0,27,62.79,0
22,102-PUNE,110148-Indira National School,11,43,43,0,34,9,100,79.07
23,117-BENGALURU,M38164-Daffodils High School,8,43,0,43,0,0,0,0
24,102-PUNE,M11078-St. Ursula High School,9,43,38,5,12,26,88.37,27.91
25,107-DELHI,270208-Govt. Sarvodaya Bal Vidyalaya,9,43,0,43,0,0,0,0
26,111-ALLAHABAD/PRAYAGRAJ,210273-Aliganj Montessori School,12,43,39,4,39,0,90.7,90.7
27,111-ALLAHABAD/PRAYAGRAJ,M21196-Amiruddaula Islamia Inter College,11,43,0,43,0,0,0,0
28,114-DEHRADUN,340200-Govt. Inter College,12,43,0,43,0,0,0,0
29,110-PATNA,"030338-Madwari Inter +2 College,",7,43,4,39,4,0,9.3,9.3
30,111-ALLAHABAD/PRAYAGRAJ,210783-Jim Corbett Public School,9,43,0,43,0,0,0,0
31,103-KOLKATA,M22099-Asansol St.Anthony Secondary School,7,42,0,42,0,0,0,0
32,114-DEHRADUN,210048-Rab Intermediate College,7,42,1,41,1,0,2.38,2.38
33,105-CHANDIGARH,050066-Dharamvati Public Sr. Sec. School,10,42,0,42,0,0,0,0
34,103-KOLKATA,M22095-Abbot Shishu Hall,8,42,0,42,0,0,0,0
35,120-RANCHI,260125-Rajkiyakrit  +2 High School,10,42,5,37,0,5,11.9,0
36,110-PATNA,J03014-District Jail,8,42,33,9,0,33,78.57,0
37,111-ALLAHABAD/PRAYAGRAJ,210151-Champa Agarwal Institute Of,8,42,0,42,0,0,0,0
38,115-BHUBANESWAR,J15159-District Jail,10,41,20,21,20,0,48.78,48.78
39,107-DELHI,M27152-St. Xavier School,7,41,0,41,0,0,0,0
40,105-CHANDIGARH,050363-Sir Chhotu Ram Modern Sr.sec.school,4,41,38,3,0,38,92.68,0
41,114-DEHRADUN,210750-S.D.P.D PUBLIC SCHOOL,6,41,0,41,0,0,0,0
42,117-BENGALURU,450058-Spastic Society Of Karnataka,11,40,40,0,30,10,97.56,73.17
43,107-DELHI,270442-Dhruva Public School,8,39,35,4,32,3,85.37,78.05
44,105-CHANDIGARH,050356-V.B.N. Senior Secondary School,9,41,41,0,23,18,100,56.1
45,104-GUWAHATI,"240005-Govt. Hr.sec. School,",9,41,7,34,1,6,17.07,2.44
46,113-BHOPAL,M10174-Madarsa Firdos Hr.sec.study Center,7,41,0,41,0,0,0,0
47,107-DELHI,270474-Indian Convent School,7,41,0,41,0,0,0,0
48,121-CHENNAI,M42004-Saudia Oriental Arabic Hr. Sec. School,10,41,41,0,41,0,100,100
49,121-CHENNAI,190147-Vedavalli Vidyalaya,7,41,30,11,0,30,73.17,0
50,105-CHANDIGARH,050506-Aryans Model Sr. Sec. School,9,41,41,0,41,0,100,100
51,111-ALLAHABAD/PRAYAGRAJ,"210156-Amar Public Inter College,",8,41,0,41,0,0,0,0
52,109-JAIPUR,170389-Floradale Public School,9,41,0,41,0,0,0,0
53,105-CHANDIGARH,050585-KVM PUBLIC SCHOOL,8,41,0,41,0,0,0,0
54,105-CHANDIGARH,050094-Gaur Brahman Vidya Parcharini Sabha,9,41,0,41,0,0,0,0
55,110-PATNA,030335-Rajkiya Inter +2 School,8,41,2,39,2,0,4.88,4.88
56,105-CHANDIGARH,050518-Aryavart High School,9,35,35,0,35,0,85.37,85.37
57,105-CHANDIGARH,050123-Deep Arya High School,4,40,0,40,0,0,0,0
58,111-ALLAHABAD/PRAYAGRAJ,M21492-Madarsa S. Islamia,6,40,0,40,0,0,0,0
59,111-ALLAHABAD/PRAYAGRAJ,210189-Sant Ramkrishan Kanya Intercollege,10,40,0,40,0,0,0,0
60,121-CHENNAI,190146-APL Global School,18,38,34,4,30,4,85,75
61,120-RANCHI,260133-+2 Zila School,9,40,0,40,0,0,0,0
62,106-KOCHI,400040-Kendriya Vidyalaya No-2,8,39,0,39,0,0,0,0
63,114-DEHRADUN,340250-Bhagirathi Vidyalaya,8,39,0,39,0,0,0,0
64,102-PUNE,280013-Kendriya Vidyalaya No.1,7,35,0,35,0,0,0,0
65,109-JAIPUR,170230-Sh. Ram Karan Joshi Govt. Hr. Sec.,9,39,39,0,39,0,100,100
66,105-CHANDIGARH,050074-Maharishi Vidya Mandir,8,39,0,39,0,0,0,0
67,110-PATNA,M03362-Sadar Alam Memorial Sr.sec.school,8,39,39,0,0,39,100,0
68,103-KOLKATA,220120-AGPN Convent & E.R. School,8,39,0,39,0,0,0,0
69,109-JAIPUR,170378-Pragati Public Sr. Sec. School,6,39,0,39,0,0,0,0
70,121-CHENNAI,190126-R.D. International School,7,39,39,0,23,16,100,58.97
71,102-PUNE,M36148-Anglo Urdu Boys High School & Jr,8,38,0,38,0,0,0,0
72,108-ABROAD/NIOS HQ,940001-LAURELS EDUCATION SERVICES WILL,8,39,0,39,0,0,0,0
73,106-KOCHI,400022-Trinity Lyceum,6,39,0,39,0,0,0,0
74,111-ALLAHABAD/PRAYAGRAJ,450105-Jyoti Badhir Vidyalaya,6,39,39,0,39,0,100,100
75,102-PUNE,M11133-MAROTRAO BANSOD JUNIOR COLLEGE,5,38,0,38,0,0,0,0
76,111-ALLAHABAD/PRAYAGRAJ,210684-R.a. Inter College,5,38,0,38,0,0,0,0
77,111-ALLAHABAD/PRAYAGRAJ,210598-T.c. Chandra Inter College,7,38,38,0,38,0,100,100
78,107-DELHI,270375-Bal Vidya Mandir Model School,6,38,29,9,0,29,76.32,0
79,114-DEHRADUN,340128-Govt. Inter College,9,38,0,38,0,0,0,0
80,118-GANDHINAGAR,M39063-St.mary's School,9,38,38,0,37,1,100,97.37
81,123-GANGTOK,"M22087-Good Shepherd School,",6,38,38,0,18,20,100,47.37
82,106-KOCHI,400067-Aliya Senior Secondary School,7,38,0,38,0,0,0,0
83,115-BHUBANESWAR,150036-150036-Jawahar Navodaya Vidyalaya,9,37,20,17,11,9,54.05,29.73
84,105-CHANDIGARH,050556-Guru Nanak Academy,8,37,26,11,0,26,70.27,0
85,121-CHENNAI,190152-Sri Sankara Vidyalaya Mat. Hr. Sec. School,11,37,12,25,2,10,32.43,5.41
86,107-DELHI,270094-Siddharth International Pub.School,8,37,0,37,0,0,0,0
87,113-BHOPAL,100183-Maa Sharda Higher Secondary School,7,37,0,37,0,0,0,0
88,103-KOLKATA,220132-Rishi Aurobindo Memorial Academy,7,37,0,37,0,0,0,0
89,104-GUWAHATI,440010-Don Bosco High School,8,37,14,23,13,1,37.84,35.14
90,106-KOCHI,400026-Shree Vivekanand Sec.school,9,37,0,37,0,0,0,0
91,121-CHENNAI,190035-Kendriya Vidyalaya No-2,8,37,1,36,0,1,2.7,0
92,109-JAIPUR,170096-Kendriya Vidyalaya,6,37,0,37,0,0,0,0
93,107-DELHI,M05365-Ajmat Khan Indian Public School,7,36,5,31,0,5,13.89,0
94,107-DELHI,050359-Ch. Chain Sukh Sr.sec. School,7,36,0,36,0,0,0,0
95,103-KOLKATA,220084-Balika Vidya Bhawan,8,36,0,36,0,0,0,0
96,121-CHENNAI,190034-Kendriya Vidyalaya No-1,10,36,0,36,0,0,0,0
97,102-PUNE,110049-Shaheed Dunichand T.kalani,8,35,0,35,0,0,0,0
98,114-DEHRADUN,340295-S.N. Memorial Public School,7,34,5,29,3,2,13.89,8.33
99,120-RANCHI,260197-Sarala Birla Public School,7,36,32,4,12,20,88.89,33.33
100,102-PUNE,110124-Gokulnath Sec. & Hr.sec. School,7,36,34,2,33,1,94.44,91.67
1,111-ALLAHABAD/PRAYAGRAJ,210556-St. Xavier's High School,10,36,36,0,26,10,100,72.22
2,104-GUWAHATI,140022-Kendriya Vidyalaya,7,36,9,27,0,9,25,0
3,105-CHANDIGARH,450179-Tapan Rehabilitition Society,4,36,2,34,0,2,5.56,0
4,118-GANDHINAGAR,040074-Smt. Sandraben Shroff Gnyan Dham School,7,36,36,0,24,12,100,66.67
5,109-JAIPUR,170135-Shiv Public Sr.sec. School,8,36,0,36,0,0,0,0
6,113-BHOPAL,J10213-District Jail,9,36,36,0,0,36,100,0
7,109-JAIPUR,170310-Vidyagram International School,5,36,0,36,0,0,0,0
8,115-BHUBANESWAR,150201-Times Scholars Gurukul,6,36,21,15,12,9,58.33,33.33
9,105-CHANDIGARH,050319-Shiv Sr.sec. School,8,36,0,36,0,0,0,0
10,117-BENGALURU,T08001-National Skill Training Institute (NSTI),16,36,0,36,0,0,0,0
11,114-DEHRADUN,340120-Govt. Inter College,8,35,35,0,25,10,100,71.43
12,114-DEHRADUN,340287-Bright Inter College,8,35,0,35,0,0,0,0
13,107-DELHI,210731-J. D. PUBLIC SCHOOL,7,35,0,35,0,0,0,0
14,110-PATNA,030085-Mahavir Inter College,6,35,0,35,0,0,0,0
15,109-JAIPUR,170441-Surya Bal Shiksha Niketan Sr. Sec. School,7,35,0,35,0,0,0,0
16,121-CHENNAI,190129-Manchester International School,6,35,0,35,0,0,0,0
17,107-DELHI,270168-Govt. Boys Sr. Sec. School,6,35,0,35,0,0,0,0
18,115-BHUBANESWAR,150012-Harobino Vidya Bhawan,6,35,21,14,6,15,60,17.14
19,114-DEHRADUN,M21389-Ale Mansoob Inter College,6,35,0,35,0,0,0,0
20,110-PATNA,M03113-Patna Muslim High School Inter Col.,7,35,4,31,4,0,11.43,11.43
21,105-CHANDIGARH,050047-Navyug Public School,7,35,0,35,0,0,0,0
22,105-CHANDIGARH,160054-A.v.m Senior Secondary School,6,34,3,31,3,0,8.82,8.82
23,117-BENGALURU,080023-Swami Vivekananda Vidyashala,7,34,0,34,0,0,0,0
24,104-GUWAHATI,450172-SHISHU SAROTHI CENTRE FOR REHABILITATION AND TRAINING FOR MULTIPLE DISABILITIES,8,34,8,26,4,4,23.53,11.76
25,103-KOLKATA,220123-SAINT CHRISTOPHER'S MISSION SCHOOL,6,34,0,34,0,0,0,0
26,118-GANDHINAGAR,M04037-St. Xavier's Vidya Vihar,7,34,34,0,30,4,100,88.24
27,105-CHANDIGARH,050591-Ideal International School,7,34,34,0,34,0,100,100
28,109-JAIPUR,M17054-Sant Hafiz Public Sec. School,7,34,0,34,0,0,0,0
29,120-RANCHI,260087-Jawahar Navodaya Vidyalaya,5,34,0,34,0,0,0,0
30,101-HYDERABAD,470005-St. Philomena High School,8,34,0,34,0,0,0,0
31,117-BENGALURU,080066-Sri Sri Ravishankar Vidya Mandir,8,34,28,6,0,28,82.35,0
32,109-JAIPUR,"170100-Kendriya Vidyalaya No. 2,",9,34,0,34,0,0,0,0
33,121-CHENNAI,420064-Kendriya Vidyalaya No-1,10,34,0,34,0,0,0,0
34,105-CHANDIGARH,050552-G. R. S. Sr. Sec. School,6,32,0,32,0,0,0,0
35,110-PATNA,"030348-Town High School,",8,34,2,32,2,0,5.88,5.88
36,105-CHANDIGARH,050326-City Sr.sec.school,6,34,34,0,7,27,100,20.59
37,114-DEHRADUN,340259-Shantivallabh Memorial Inter Colleg,9,30,0,30,0,0,0,0
38,102-PUNE,M11096-St. Felix High School,8,34,31,3,27,4,91.18,79.41
39,121-CHENNAI,190122-B V M Global School,8,30,27,3,5,22,79.41,14.71
40,114-DEHRADUN,"340159-Apollo International School,",6,30,1,29,1,0,2.94,2.94
41,107-DELHI,270201-Delhi Jain Public Sr.sec. School,8,34,0,34,0,0,0,0
42,105-CHANDIGARH,050630-Shri Krishna Public School,7,34,0,34,0,0,0,0
43,105-CHANDIGARH,450094-National School For The Handi.sch.,9,33,0,33,0,0,0,0
44,122-DHARAMSALA,060015-Govt.(b) Sr. Sec. School,6,31,0,31,0,0,0,0
45,104-GUWAHATI,M13018-Ferrando Speech and Hearing Centre,6,33,33,0,8,25,100,24.24
46,114-DEHRADUN,M21115-H.b.h.high School,10,33,0,33,0,0,0,0
47,125-JAMMU,070009-Govt. Higher Secondary School,6,33,0,33,0,0,0,0
48,114-DEHRADUN,M34251-Ranikhet (mission) Inter  College,8,33,0,33,0,0,0,0
49,105-CHANDIGARH,050391-Om Shanti Shiksha Sadan Sr.sec.sch.,4,33,0,33,0,0,0,0
50,103-KOLKATA,460527-Budge Budge St. Paul's Day School,7,33,0,33,0,0,0,0
51,103-KOLKATA,220121-Army Public School,8,33,0,33,0,0,0,0
52,114-DEHRADUN,M21064-Guru Tegh Bahadur Public School,7,33,0,33,0,0,0,0
53,103-KOLKATA,220031-Kendriya Vidyalaya No.1,7,33,0,33,0,0,0,0
54,105-CHANDIGARH,050553-B R International Public School,8,33,24,9,0,24,72.73,0
55,121-CHENNAI,190164-Good Word Public School,8,33,32,1,29,3,96.97,87.88
56,104-GUWAHATI,440006-Kampur Adarsha High School,6,33,6,27,3,3,18.18,9.09
57,107-DELHI,270247-Universal Public School,8,33,0,33,0,0,0,0
58,125-JAMMU,"070023-Arya Kanya Vidyalaya High School,",7,33,2,31,0,2,6.06,0
59,117-BENGALURU,080024-Deccan International School,8,32,19,13,14,5,57.58,42.42
60,109-JAIPUR,170174-Govt. Hr. Sec. School,6,32,0,32,0,0,0,0
61,107-DELHI,M05439-Sun Rise Public School,5,32,0,32,0,0,0,0
62,110-PATNA,"030257-+2 Zila School,",6,32,3,29,2,1,9.38,6.25
63,104-GUWAHATI,M02067-AUXILIUM CONVENT HIGH SCHOOL,7,32,32,0,5,27,100,15.63
64,114-DEHRADUN,210050-National Muslim Academy,3,32,32,0,0,32,100,0
65,111-ALLAHABAD/PRAYAGRAJ,210338-Bal Mitra School,6,32,0,32,0,0,0,0
66,107-DELHI,"270393-Blooming Dales Public School,",7,32,0,32,0,0,0,0
67,121-CHENNAI,420084-Veera Savarkar Netaji Matric.school,5,32,32,0,32,0,100,100
68,109-JAIPUR,170020-Kendriya Vidyalaya No.1,7,32,3,29,0,3,9.38,0
69,114-DEHRADUN,M21424-Madarsa Islamia Talimul Quran,7,32,31,1,28,3,96.88,87.5
70,107-DELHI,270487-Army Public School,7,32,0,32,0,0,0,0
71,103-KOLKATA,220105-Chakdaha Model School,6,32,0,32,0,0,0,0
72,106-KOCHI,M40060-Mcf Public School,4,32,20,12,5,15,62.5,15.63
73,104-GUWAHATI,020034-Kendriya Vidyalaya,7,32,10,22,2,8,31.25,6.25
74,107-DELHI,270561-Holy World School,7,32,32,0,32,0,100,100
75,108-ABROAD/NIOS HQ,"320511-HQ 10 Arty Bde,",8,32,0,32,0,0,0,0
76,109-JAIPUR,170089-Sumitra Memorial Public School,6,32,20,12,0,20,62.5,0
77,114-DEHRADUN,340006-Children's Sr. Academy,6,32,0,32,0,0,0,0
78,102-PUNE,M11134-St. Mary's High School,7,32,0,32,0,0,0,0
79,121-CHENNAI,"190028-Kendriya Vidyalaya,",7,31,0,31,0,0,0,0
80,120-RANCHI,260031-Bokaro Public School,6,31,29,2,26,3,93.55,83.87
81,109-JAIPUR,170131-Badhal Sunrise Senior Secondary,7,31,31,0,31,0,100,100
82,106-KOCHI,400052-Kendriya Vidyalaya,6,31,0,31,0,0,0,0
83,121-CHENNAI,190150-Primrose Schools,8,26,0,26,0,0,0,0
84,103-KOLKATA,460525-AGPN Convent & E.R. School,6,31,0,31,0,0,0,0
85,107-DELHI,210575-Braham Rishi Krishan Dutt Inter,7,31,0,31,0,0,0,0
86,104-GUWAHATI,200014-Santirbazar H.s.school,4,31,13,18,0,13,41.94,0
87,114-DEHRADUN,M21653-Pragati Senior Secondary School,6,31,0,31,0,0,0,0
88,109-JAIPUR,170218-B.r. Khokhar Memorial Sr.sec.school,6,31,0,31,0,0,0,0
89,113-BHOPAL,100134-Jawahar Navodaya Vidyalaya,8,31,0,31,0,0,0,0
90,103-KOLKATA,460518-Rajasthan Vidyapith,6,31,0,31,0,0,0,0
91,105-CHANDIGARH,050603-M.S Saraswati Sr. sec. School,4,31,0,31,0,0,0,0
92,110-PATNA,030091-Jayanand Ucch Vidyalaya,6,30,29,1,12,17,96.67,40
93,118-GANDHINAGAR,390123-Jay Ambe International School,7,30,30,0,23,7,100,76.67
94,104-GUWAHATI,"020043-Kendriya Vidyalaya ONGC,",8,30,15,15,1,14,50,3.33
95,105-CHANDIGARH,160125-Krishna College of Hr. Education,5,30,30,0,30,0,100,100
96,105-CHANDIGARH,160142-S.D. Public School,6,30,0,30,0,0,0,0
97,105-CHANDIGARH,J16006-Modern Central Jail,4,30,0,30,0,0,0,0
98,108-ABROAD/NIOS HQ,950021-Agi's Atlas International College,0,0,0,0,0,0,0,0
99,103-KOLKATA,220058-Paranami Balika Vidya Mandir,5,30,0,30,0,0,0,0
100,113-BHOPAL,M10203-Madarsa Hazrat Bilal,6,30,0,30,0,0,0,0
1,110-PATNA,030079-Gandhi Inter Vidyalay,7,29,2,27,2,0,6.67,6.67
2,120-RANCHI,260199-Kids Garden Secondary School,6,26,20,6,20,0,66.67,66.67
3,115-BHUBANESWAR,T15012-CENTURION PRIVATE ITI,14,30,30,0,30,0,100,100
4,113-BHOPAL,M10095-Adivasi & Viklang Hr.sec.school,7,30,0,30,0,0,0,0
5,113-BHOPAL,M38263-Deniyat Fadeha Madarsa,5,30,0,30,0,0,0,0
6,104-GUWAHATI,130030-Army Public School,6,30,30,0,29,1,100,96.67
7,110-PATNA,030326-Rajkiya +2 High School,7,30,0,30,0,0,0,0
8,110-PATNA,"030259-Govt.high School,",4,30,4,26,3,1,13.33,10
9,121-CHENNAI,190030-Kendriya Vidyalaya,8,30,0,30,0,0,0,0
10,105-CHANDIGARH,050526-Green Fields Public School,6,30,0,30,0,0,0,0
11,111-ALLAHABAD/PRAYAGRAJ,210419-Career Convent Girls College,6,30,0,30,0,0,0,0
12,121-CHENNAI,190065-P.k. Govt. Girls Hr.sec. School,6,29,0,29,0,0,0,0
13,115-BHUBANESWAR,150183-Barrk's High School,6,29,14,15,9,5,48.28,31.03
14,107-DELHI,M38357-Victoria Public Senior Secondary School,9,29,0,29,0,0,0,0
15,105-CHANDIGARH,050657-Adarsh Convent Sr. Sec. School,5,29,14,15,9,5,48.28,31.03
16,111-ALLAHABAD/PRAYAGRAJ,210759-MUKULARANYAM ENGLISH SCHOOL,9,29,23,6,15,8,79.31,51.72
17,120-RANCHI,260138-+2 R.k. High School,6,29,14,15,0,14,48.28,0
18,114-DEHRADUN,340262-V.m.j.s. Govt. Inter College,7,29,0,29,0,0,0,0
19,121-CHENNAI,420063-Kendriya Vidyalaya,6,29,0,29,0,0,0,0
20,111-ALLAHABAD/PRAYAGRAJ,210187-Dolly's Public Inter College,5,29,0,29,0,0,0,0
21,105-CHANDIGARH,050604-Holy Wisdom Convent,3,29,0,29,0,0,0,0
22,114-DEHRADUN,340214-Kendriya  Vidyalaya,6,29,0,29,0,0,0,0
23,114-DEHRADUN,340288-P.S. Model Hr. Secondary School,6,29,29,0,29,0,100,100
24,105-CHANDIGARH,050158-M.d.n.sr.sec.school,7,28,21,7,0,21,75,0
25,117-BENGALURU,080044-Kendriya Vidyalaya No. 2,5,28,28,0,28,0,100,100
26,107-DELHI,050538-BALAJI PUBLIC SCHOOL,6,28,0,28,0,0,0,0
27,125-JAMMU,070056-Army Public School,6,28,0,28,0,0,0,0
28,117-BENGALURU,450024-Asha Kiran Special Needs School,6,28,0,28,0,0,0,0
29,107-DELHI,210612-Bal Jyoti Public School,6,28,0,28,0,0,0,0
30,118-GANDHINAGAR,040079-P R Mukhi Sec. & Hr. Sec. School,6,28,28,0,20,8,100,71.43
31,103-KOLKATA,230009-Govt. Model Sr.Sec. School,7,28,16,12,0,16,57.14,0
32,115-BHUBANESWAR,150177-Brajamohan High School,5,28,18,10,11,7,64.29,39.29
33,116-VISAKHAPATNAM,010167-Kendriya Vidyalaya,7,26,23,3,0,23,82.14,0
34,118-GANDHINAGAR,390093-Navrachana School,6,28,28,0,26,2,100,92.86
35,105-CHANDIGARH,160162-Shakargarh DAV Sr. Sec. School,8,28,0,28,0,0,0,0
36,111-ALLAHABAD/PRAYAGRAJ,M21001-Faiz-e-aam Modern Education Centre,5,28,0,28,0,0,0,0
37,107-DELHI,M38077-Society For Promotion Of Education,6,28,0,28,0,0,0,0
38,114-DEHRADUN,340309-Rajputana College,5,28,0,28,0,0,0,0
39,102-PUNE,110048-Bharti Sanskrit Vidya Niketaram,6,28,28,0,0,28,100,0
40,115-BHUBANESWAR,M41083-Syed Seminary High School,6,28,24,4,13,11,85.71,46.43
41,109-JAIPUR,170097-Kendriya Vidyalaya No-6,6,28,0,28,0,0,0,0
42,109-JAIPUR,170402-Shanti Niketan Sr. Sec. School,6,28,27,1,26,1,96.43,92.86
43,107-DELHI,270385-NEW OXFORD PUBLIC SCHOOL,6,28,0,28,0,0,0,0
44,109-JAIPUR,170412-N.V.N Sr. Sec School,5,28,0,28,0,0,0,0
45,107-DELHI,450148-TAMANA SPECIAL SCHOOL,7,26,0,26,0,0,0,0
46,108-ABROAD/NIOS HQ,320103-HQ 33 CORPS HRDC,7,28,0,28,0,0,0,0
47,102-PUNE,M11087-St.john's School,6,22,22,0,20,2,81.48,74.07
48,105-CHANDIGARH,160105-Saraswati Vidya Mandir Senior,5,27,0,27,0,0,0,0
49,118-GANDHINAGAR,040082-S.V Public School,5,27,27,0,25,2,100,92.59
50,123-GANGTOK,220118-Little Flower School,7,26,26,0,26,0,96.3,96.3
51,105-CHANDIGARH,050620-G.L Public School,4,27,27,0,27,0,100,100
52,121-CHENNAI,190026-Swami Sivananda Vidya Samiti,9,27,20,7,7,13,74.07,25.93
53,115-BHUBANESWAR,150015-S.aurobindo Integral Edu.& Res.cen.,5,27,27,0,20,7,100,74.07
54,114-DEHRADUN,340268-GOVT. INTER COLLEGE,7,27,0,27,0,0,0,0
55,102-PUNE,M11067-St.paul's English School&jr.college,5,27,14,13,14,0,51.85,51.85
56,105-CHANDIGARH,050639-Hare Krishna International Sr. Sec. School,6,27,25,2,0,25,92.59,0
57,118-GANDHINAGAR,040077-Genius English Medium School,8,27,27,0,19,8,100,70.37
58,117-BENGALURU,080063-SRS Pre-University College,5,27,0,27,0,0,0,0
59,107-DELHI,270471-Chhotu Ram Public School,7,27,0,27,0,0,0,0
60,105-CHANDIGARH,050586-SKYPATH GLOBAL SCHOOL,6,27,0,27,0,0,0,0
61,111-ALLAHABAD/PRAYAGRAJ,210653-Samrat Ashok Inter College,4,27,27,0,27,0,100,100
62,107-DELHI,050390-Saarthi Public Sr.sec. School,4,27,0,27,0,0,0,0
63,121-CHENNAI,190160-Hindustan International School,6,27,0,27,0,0,0,0
64,103-KOLKATA,220041-Vidyasagar Higher Secondary School,5,27,27,0,27,0,100,100
65,109-JAIPUR,170217-R.k. Public Senior Secondary School,5,27,27,0,27,0,100,100
66,110-PATNA,"030334-+2 Li Academy,",6,26,0,26,0,0,0,0
67,107-DELHI,270331-Shibban Modern Public Sec. School,3,26,0,26,0,0,0,0
68,111-ALLAHABAD/PRAYAGRAJ,210170-Savitri Devi Shanker Lal Sharma,5,26,0,26,0,0,0,0
69,122-DHARAMSALA,060099-Rudra International School,5,26,0,26,0,0,0,0
70,125-JAMMU,070057-Army Public School,6,26,18,8,14,4,69.23,53.85
71,122-DHARAMSALA,060035-Govt. Senior Secondary School,5,26,4,22,3,1,15.38,11.54
72,104-GUWAHATI,140033-CHARITY RESIDENTIAL SCHOOL,5,26,5,21,0,5,19.23,0
73,107-DELHI,270478-Jr Public School,5,26,0,26,0,0,0,0
74,111-ALLAHABAD/PRAYAGRAJ,"210282-Shishu Vidya Peeth Inter College,",5,26,0,26,0,0,0,0
75,105-CHANDIGARH,160047-M. G. M. Sr. School,6,26,0,26,0,0,0,0
76,107-DELHI,210776-Bhartiyam School,5,26,0,26,0,0,0,0
77,107-DELHI,270514-RD INTERNATIONAL SCHOOL,6,26,0,26,0,0,0,0
78,120-RANCHI,260144-S.s. +2 High School,4,26,0,26,0,0,0,0
79,104-GUWAHATI,140003-Jawahar Navodaya Vidyalaya,4,26,14,12,3,11,53.85,11.54
80,115-BHUBANESWAR,150175-C.s.b. Zilla School,6,26,11,15,6,5,42.31,23.08
81,121-CHENNAI,190161-Sri Sankara Matriculation Hr. Sec. School,3,22,0,22,0,0,0,0
82,107-DELHI,210676-New Sainik Public School,5,26,0,26,0,0,0,0
83,102-PUNE,360133-Ali Yavar Jung National Institute,5,26,0,26,0,0,0,0
84,105-CHANDIGARH,050166-Holy Angel High School,7,26,26,0,15,11,100,57.69
85,119-RAIPUR,290050-Jatan Devi Daga Hr.sec.school,6,25,0,25,0,0,0,0
86,113-BHOPAL,J10005-District Jail,5,25,25,0,0,25,100,0
87,114-DEHRADUN,340315-S.B.N Academy,6,25,0,25,0,0,0,0
88,102-PUNE,110135-Kendriya Vidyalaya,4,25,24,1,0,24,96,0
89,104-GUWAHATI,020061-R J Senior Secondary School,4,25,9,16,2,7,36,8
90,107-DELHI,M21658-Madrasa Maulana Abdul Kalam Azad,4,25,0,25,0,0,0,0
91,102-PUNE,110025-Pal Rajendra English High School,5,25,0,25,0,0,0,0
92,118-GANDHINAGAR,390052-St. Xavier's High School,5,25,25,0,25,0,100,100
93,117-BENGALURU,080032-Jawahar Navodaya Vidyalaya,4,23,0,23,0,0,0,0
94,111-ALLAHABAD/PRAYAGRAJ,210157-Aditya Birla Intermediate College Renukoot,6,25,0,25,0,0,0,0
95,114-DEHRADUN,340164-Anandale Public School,5,25,0,25,0,0,0,0
96,110-PATNA,030178-Kendriya Vidyalaya,6,25,0,25,0,0,0,0
97,105-CHANDIGARH,050055-Adarsh High School,5,25,25,0,25,0,100,100
98,105-CHANDIGARH,160088-Deshmesh Public School,5,25,0,25,0,0,0,0
99,107-DELHI,450167-Institute Of Rehabilitation,6,25,25,0,25,0,100,100
100,105-CHANDIGARH,250008-Shishu Niketan Model Sr. Sec.school,7,25,0,25,0,0,0,0
1,110-PATNA,030057-Jawahar Navodaya Vidyalaya,5,25,0,25,0,0,0,0
2,105-CHANDIGARH,050668-Sada Sukh Memorial Public School,6,25,8,17,0,8,32,0
3,117-BENGALURU,080060-Air Force School,6,25,0,25,0,0,0,0
4,105-CHANDIGARH,160155-Mount Litera Zee School,5,25,17,8,0,17,68,0
5,118-GANDHINAGAR,390161-Shri V D Mayavanshi High School,5,25,25,0,10,15,100,40
6,103-KOLKATA,380303-Kankinara Himayatul Ghurba,4,25,2,23,2,0,8,8
7,109-JAIPUR,170384-Gyan Jyoti Model School,4,24,2,22,0,2,8.33,0
8,125-JAMMU,070058-Army Public School,6,24,24,0,13,11,100,54.17
9,111-ALLAHABAD/PRAYAGRAJ,210056-Jawahar Navodaya Vidyalaya,4,24,0,24,0,0,0,0
10,109-JAIPUR,170307-Bharti Vidhya Niketan Sr.sec.school,5,24,0,24,0,0,0,0
11,105-CHANDIGARH,160121-Dashmesh Public Sr.Sec. School,4,24,0,24,0,0,0,0
12,118-GANDHINAGAR,390157-Chavda S J And Shah S B High School,4,24,24,0,24,0,100,100
13,114-DEHRADUN,M38368-F.D Islamia Inter College,5,24,0,24,0,0,0,0
14,114-DEHRADUN,210225-Red Rose High School,5,24,0,24,0,0,0,0
15,107-DELHI,050505-New Era Sr.sec. School,5,24,0,24,0,0,0,0
16,121-CHENNAI,190115-Kmc Public Senior Secondary School,6,24,24,0,0,24,100,0
17,114-DEHRADUN,340165-Adarsh Shishu Niketan Uchachattar,6,24,0,24,0,0,0,0
18,113-BHOPAL,100307-Army Public School No.1,6,24,0,24,0,0,0,0
19,107-DELHI,050179-Adarsh Janta Sr.sec.school,4,24,0,24,0,0,0,0
20,105-CHANDIGARH,160037-Sacred Heart High School,4,24,0,24,0,0,0,0
21,107-DELHI,050592-D V M High School,4,24,24,0,24,0,100,100
22,104-GUWAHATI,020068-Icon Academy Jr. College,8,24,9,15,0,9,37.5,0
23,104-GUWAHATI,020067-Noonmati Public School,5,24,4,20,0,4,16.67,0
24,125-JAMMU,070044-Vishaw Jyoti Shishu Niketan H.s.,4,24,0,24,0,0,0,0
25,121-CHENNAI,190009-Kendriya Vidyalaya,5,22,0,22,0,0,0,0
26,114-DEHRADUN,340104-Govt.inter College,6,24,1,23,0,1,4.17,0
27,109-JAIPUR,170387-Taigor Shikshan Sansthan Sr.Sec.Sch,5,24,0,24,0,0,0,0
28,107-DELHI,M21200-Amity International School,6,24,8,16,0,8,33.33,0
29,106-KOCHI,090052-Kendriya Vidyaloaya No-1,7,24,19,5,12,7,79.17,50
30,114-DEHRADUN,340121-Govt. Inter College,4,24,20,4,4,16,83.33,16.67
31,121-CHENNAI,190067-Govt. Higher Secondary School,5,23,0,23,0,0,0,0
32,115-BHUBANESWAR,150184-A.j.o. High School,5,23,23,0,21,2,100,91.3
33,109-JAIPUR,170208-Govt. Sr.sec. School,7,23,2,21,0,2,8.7,0
34,121-CHENNAI,190001-Sri.vidya Mandirsec.sch.&jr.college,5,23,0,23,0,0,0,0
35,105-CHANDIGARH,050624-Sun Rise Senior Secondary School,3,23,0,23,0,0,0,0
36,105-CHANDIGARH,160024-Shivalik Hills Sr. Sec. Public School,4,23,23,0,17,6,100,73.91
37,121-CHENNAI,190117-The Camford International School,6,23,0,23,0,0,0,0
38,117-BENGALURU,080041-Jawahar Navodaya Vidyalaya,3,23,0,23,0,0,0,0
39,102-PUNE,110029-St.joseph Convent Girls High School,4,18,0,18,0,0,0,0
40,111-ALLAHABAD/PRAYAGRAJ,210165-Sh. Mohanlal Adarsh Inter College,5,23,23,0,0,23,100,0
41,105-CHANDIGARH,050428-Sarvodaya Senior Secondary School,5,23,0,23,0,0,0,0
42,113-BHOPAL,100172-Bal Bharti Public School,4,23,0,23,0,0,0,0
43,114-DEHRADUN,M21409-Madarsa Babul Ilm,6,23,0,23,0,0,0,0
44,106-KOCHI,M09098-Gods Own Public School,5,23,21,2,19,2,91.3,82.61
45,125-JAMMU,070050-New Naveen Model Hr.sec. School,5,23,0,23,0,0,0,0
46,107-DELHI,050293-B.r.m.sr.sec. School,5,23,0,23,0,0,0,0
47,114-DEHRADUN,340216-Govt. Inter College,6,23,0,23,0,0,0,0
48,111-ALLAHABAD/PRAYAGRAJ,210644-Study Hall,6,23,23,0,4,19,100,17.39
49,119-RAIPUR,290065-Jawahar Navodaya Vidyalaya,4,23,0,23,0,0,0,0
50,105-CHANDIGARH,050548-BKN Public School,4,23,0,23,0,0,0,0
51,114-DEHRADUN,210242-Gyan Bharti Inter College,4,22,0,22,0,0,0,0
52,121-CHENNAI,M19107-Kh Matriculation Boys Hr.sec.school,5,22,22,0,6,16,100,27.27
53,111-ALLAHABAD/PRAYAGRAJ,210809-Green Light Public School,5,22,0,22,0,0,0,0
54,121-CHENNAI,190118-Pushpalata Vidya Mandir,5,22,20,2,3,17,90.91,13.64
55,110-PATNA,030371-Jawahar Navodaya Vidyalaya,5,22,17,5,0,17,77.27,0
56,107-DELHI,050605-Jhankar High School,5,22,0,22,0,0,0,0
57,110-PATNA,030081-Anugrah Ucch Vidyalaya,4,22,0,22,0,0,0,0
58,105-CHANDIGARH,050149-Saint Nischal Sr.sec.school,5,22,0,22,0,0,0,0
59,107-DELHI,270441-Glorious Public School,6,22,2,20,0,2,9.09,0
60,101-HYDERABAD,470214-Geethanjali Junior College,4,22,22,0,22,0,100,100
61,114-DEHRADUN,340109-Govt. Intermediate College,6,22,0,22,0,0,0,0
62,115-BHUBANESWAR,150191-Chitalo Mohavidyalaya,4,22,12,10,8,4,54.55,36.36
63,118-GANDHINAGAR,390128-L D R International School,5,22,22,0,16,6,100,72.73
64,105-CHANDIGARH,050325-Arya Sr.sec.school,3,22,0,22,0,0,0,0
65,123-GANGTOK,180012-Govt. Senior Secondary School,5,22,0,22,0,0,0,0
66,117-BENGALURU,480003-Delhi Public School,8,22,21,1,11,10,95.45,50
67,125-JAMMU,070059-Tiny Tots Hr.Sec. School,3,22,0,22,0,0,0,0
68,115-BHUBANESWAR,150185-Birsa Munda Vidyapitha,6,22,10,12,1,9,45.45,4.55
69,118-GANDHINAGAR,040072-NAND VIDYA NIKETAN,2,19,19,0,8,11,90.48,38.1
70,110-PATNA,030373-Jawahar Navodaya Vidyalaya,4,20,0,20,0,0,0,0
71,104-GUWAHATI,020029-Kendriya Vidyalaya,4,21,17,4,13,4,80.95,61.9
72,107-DELHI,210787-Delhi Public School,4,21,0,21,0,0,0,0
73,102-PUNE,110136-Kendriya Vidyalaya No.1,5,21,21,0,3,18,100,14.29
74,105-CHANDIGARH,M16113-SHRI GURU HARKRISHAN PUBLIC SCHOOL,4,21,0,21,0,0,0,0
75,105-CHANDIGARH,050644-Green Valley International School,4,21,0,21,0,0,0,0
76,113-BHOPAL,100272-Sakshi High School,4,21,20,1,0,20,95.24,0
77,102-PUNE,360042-Jath High School,4,21,21,0,0,21,100,0
78,111-ALLAHABAD/PRAYAGRAJ,210450-Vinayak Academy Inter College,4,21,0,21,0,0,0,0
79,107-DELHI,270413-Jeevan Public School,5,21,0,21,0,0,0,0
80,105-CHANDIGARH,050214-Golden Sr. Sec. School,5,21,0,21,0,0,0,0
81,119-RAIPUR,290038-Uday Higher Secondary School,4,21,0,21,0,0,0,0
82,109-JAIPUR,170021-Kendriya Vidyalaya,5,21,8,13,0,8,38.1,0
83,103-KOLKATA,180017-Govt. Senior Secondary School,3,21,4,17,4,0,19.05,19.05
84,105-CHANDIGARH,050568-MAM CHAND PUBLIC SCHOOL ,4,21,0,21,0,0,0,0
85,109-JAIPUR,170344-M.r. Adarsh Academy Sec. School,5,21,0,21,0,0,0,0
86,121-CHENNAI,190032-Kendriya Vidyalaya,5,21,0,21,0,0,0,0
87,116-VISAKHAPATNAM,010164-Kendriya Vidyalaya No.1,4,16,15,1,0,15,71.43,0
88,109-JAIPUR,170372-J.D. International School,5,21,21,0,18,3,100,85.71
89,104-GUWAHATI,120005-D' Regina Higher Secondary School,5,21,8,13,6,2,38.1,28.57
90,114-DEHRADUN,210484-Subhash Smarak Inter College,4,21,0,21,0,0,0,0
91,104-GUWAHATI,020014-Maria Public Educational Trust,4,20,20,0,16,4,100,80
92,105-CHANDIGARH,050562-Harkishan Memorial Public School,4,20,0,20,0,0,0,0
93,103-KOLKATA,230012-Govt. Senior Secondary School,4,20,0,20,0,0,0,0
94,121-CHENNAI,190106-H.L.C. International,3,20,20,0,19,1,100,95
95,118-GANDHINAGAR,040070-The New Tulip International Schools,4,20,20,0,14,6,100,70
96,109-JAIPUR,170334-Kendriya Vidya Mandir Sr.sec.school,5,20,1,19,0,1,5,0
97,104-GUWAHATI,020059-Orang Higher Secondary School,4,20,5,15,0,5,25,0
98,110-PATNA,030267-Kamala Nehru Shishu Vihar,4,20,0,20,0,0,0,0
99,109-JAIPUR,170407-JANKI DEVI MEMORIAL PUBLIC SCHOOL,4,20,18,2,16,2,90,80
100,104-GUWAHATI,M13011-St.paul's Secondary School,2,20,6,14,4,2,30,20
1,118-GANDHINAGAR,040067-Delhi Public School,3,16,16,0,13,3,80,65
2,105-CHANDIGARH,050508-Gitanjali Sr.Sec. School,3,20,20,0,20,0,100,100
3,107-DELHI,210599-J.p.s. Global Academy,4,20,0,20,0,0,0,0
4,103-KOLKATA,220026-North Point Sr Sec.school,3,20,0,20,0,0,0,0
5,107-DELHI,270159-Govt. Sarvodaya Bal Vidyalaya No.-1,5,20,0,20,0,0,0,0
6,103-KOLKATA,220079-Godwin Modern School,4,20,5,15,4,1,25,20
7,105-CHANDIGARH,050147-Bal Bharti Sr.sec.school,4,20,0,20,0,0,0,0
8,115-BHUBANESWAR,410147-Centurion University of Technology and Management,3,20,8,12,5,3,40,25
9,101-HYDERABAD,470001-Kendriya Vidyalaya,2,20,0,20,0,0,0,0
10,105-CHANDIGARH,M16103-Guru Nanak Dev Model Sr.sec.school,4,20,0,20,0,0,0,0
11,121-CHENNAI,M42002-Crescent Matric Hr.sec. School,4,20,20,0,20,0,100,100
12,109-JAIPUR,T17008-Sushila Devi Pvt. ITI,10,20,0,20,0,0,0,0
13,107-DELHI,270560-Guru Angad Public School,4,20,0,20,0,0,0,0
14,117-BENGALURU,080059-East West Public School,4,20,0,20,0,0,0,0
15,104-GUWAHATI,"M02016-Don Bosco School, Sundempuri,",5,19,19,0,18,1,100,94.74
16,117-BENGALURU,080055-National Centre For Excellence,6,19,0,19,0,0,0,0
17,105-CHANDIGARH,050401-Golden Public School,4,19,0,19,0,0,0,0
18,119-RAIPUR,290173-Krishna Public School,3,19,16,3,0,16,84.21,0
19,114-DEHRADUN,340281-P.d.s.s. Inter College,4,19,10,9,0,10,52.63,0
20,114-DEHRADUN,340265-J.b. Memorial Academy,5,18,8,10,4,4,42.11,21.05
21,105-CHANDIGARH,050462-Gian Jyoti Senior Secondary School,3,19,0,19,0,0,0,0
22,111-ALLAHABAD/PRAYAGRAJ,210116-Holy Faith Inter College,4,19,0,19,0,0,0,0
23,107-DELHI,050629-Golden Valley International School,4,19,0,19,0,0,0,0
24,120-RANCHI,260103-+2 High School,3,19,0,19,0,0,0,0
25,109-JAIPUR,170018-Kendriya Vidyalaya No. 1,4,19,4,15,0,4,21.05,0
26,104-GUWAHATI,240002-Govt. Hr. Sec.school,4,19,4,15,2,2,21.05,10.53
27,109-JAIPUR,V17001-SMT. MOHARI DEVI TAPARIA VED VIDYALAYA SAMITI,4,19,0,19,0,0,0,0
28,114-DEHRADUN,M38193-Madarsa Babul Ilm,4,19,0,19,0,0,0,0
29,105-CHANDIGARH,160065-St.kabir Convent School,3,19,19,0,17,2,100,89.47
30,110-PATNA,030248-V.m.high School,4,19,5,14,0,5,26.32,0
31,107-DELHI,050584-RBSM PUBLIC SCHOOL,4,19,0,19,0,0,0,0
32,104-GUWAHATI,130029-Army Public School,3,19,7,12,3,4,36.84,15.79
33,114-DEHRADUN,340293-RAJEEV GANDHI NAVODAYA VIDYALAYA,3,19,3,16,3,0,15.79,15.79
34,109-JAIPUR,170112-Shree Rishikul Secondary School,4,19,0,19,0,0,0,0
35,113-BHOPAL,100301-Govt. Koushal Vikash Kendra Academy,4,19,11,8,0,11,57.89,0
36,120-RANCHI,260118-+2 S.s.d. High School,4,19,0,19,0,0,0,0
37,107-DELHI,270353-Spring Meadows Public School,4,19,13,6,13,0,68.42,68.42
38,119-RAIPUR,M29055-The Jain International School,4,19,0,19,0,0,0,0
39,109-JAIPUR,170427-Doon Children Academy Sr. Sec. School,4,19,3,16,0,3,15.79,0
40,107-DELHI,050615-Modern International Sr. Sec. School,3,18,0,18,0,0,0,0
41,113-BHOPAL,100006-Kendriya Vidyalaya,4,18,0,18,0,0,0,0
42,110-PATNA,450082-Mukti Niketan Bhagalpur,4,18,0,18,0,0,0,0
43,107-DELHI,270450-Aristotle Public School,4,18,0,18,0,0,0,0
44,109-JAIPUR,170232-S.m.m. Govt. Girl's Hr.sec. School,3,18,0,18,0,0,0,0
45,110-PATNA,030083-Hit Narayan Kshatriya +2 Vidyalaya,3,13,0,13,0,0,0,0
46,110-PATNA,030064-Zila School,3,16,0,16,0,0,0,0
47,118-GANDHINAGAR,040038-Government Higher Secondary School,3,18,18,0,5,13,100,27.78
48,121-CHENNAI,190165-SRM Public School,4,18,0,18,0,0,0,0
49,123-GANGTOK,180006-Kendriya Vidyalaya,3,18,12,6,2,10,66.67,11.11
50,116-VISAKHAPATNAM,010172-Kendriya Vidyalaya,3,18,18,0,1,17,100,5.56
51,114-DEHRADUN,210348-Tiny Tots College,5,18,16,2,16,0,88.89,88.89
52,110-PATNA,"030251-Raj High School,",4,18,18,0,15,3,100,83.33
53,121-CHENNAI,190114-S.s.v.m. World School,5,18,0,18,0,0,0,0
54,110-PATNA,030250-Govt. Higher Secondary School,4,18,0,18,0,0,0,0
55,111-ALLAHABAD/PRAYAGRAJ,210321-Dr.s.radha Krishnan Public Inter,5,18,0,18,0,0,0,0
56,104-GUWAHATI,M02048-Sacred Heart School,4,18,18,0,18,0,100,100
57,111-ALLAHABAD/PRAYAGRAJ,210483-Jawahar Navodaya Vidyalaya,4,18,0,18,0,0,0,0
58,113-BHOPAL,M10278-St. Joseph's Convent Senior Sec. School,3,18,17,1,10,7,94.44,55.56
59,118-GANDHINAGAR,040044-Kendriya Vidyalaya,3,18,18,0,11,7,100,61.11
60,101-HYDERABAD,M47181-Azaan International School,6,18,17,1,17,0,94.44,94.44
61,122-DHARAMSALA,060018-Govt. Boys Sr. Sec. School,5,18,14,4,0,14,77.78,0
62,111-ALLAHABAD/PRAYAGRAJ,210057-Kendriya Vidyalaya,2,17,0,17,0,0,0,0
63,114-DEHRADUN,340302-Govt. Inter College,4,15,15,0,15,0,88.24,88.24
64,106-KOCHI,090089-Model Public School,2,9,0,9,0,0,0,0
65,110-PATNA,030287-P.n.anglo Sanskrit Ucch Vidyalaya,4,17,0,17,0,0,0,0
66,107-DELHI,270553-White Leaf Public School,3,17,0,17,0,0,0,0
67,107-DELHI,M27480-Jai Hind Public School,2,16,0,16,0,0,0,0
68,109-JAIPUR,170261-Tagore Global International School,3,17,0,17,0,0,0,0
69,111-ALLAHABAD/PRAYAGRAJ,210278-Jai Devi Awasthi Inter College,3,17,0,17,0,0,0,0
70,102-PUNE,110060-New Modern English High School,4,17,0,17,0,0,0,0
71,115-BHUBANESWAR,T15015-Komand Private Industrial Training Institute,3,17,14,3,10,4,82.35,58.82
72,119-RAIPUR,290170-Dr. Milap Ram Sahu Vidhyalaya (M.R.S.V),5,17,3,14,0,3,17.65,0
73,105-CHANDIGARH,050206-A.P. Garg Public School,4,17,0,17,0,0,0,0
74,114-DEHRADUN,340312-Uttranchal Children's Academy Senior Secondary School,3,17,0,17,0,0,0,0
75,120-RANCHI,260107-S.s. +2 Vidyalaya,2,17,0,17,0,0,0,0
76,109-JAIPUR,170195-Govt. Sr. Sec. School,4,17,0,17,0,0,0,0
77,107-DELHI,270511-New Krishna Model Public School ,3,17,5,12,0,5,29.41,0
78,102-PUNE,M11113-St. Marys Convent School Jr college,3,17,0,17,0,0,0,0
79,121-CHENNAI,190015-Maharishi Vidya Mandir,3,17,0,17,0,0,0,0
80,118-GANDHINAGAR,390091-M.B. Patel Gyanjot Vidhya Vihar,4,17,17,0,13,4,100,76.47
81,101-HYDERABAD,380119-Al-Ameen Educational Society,5,17,8,9,1,7,47.06,5.88
82,104-GUWAHATI,440005-Sai Rns Academy,3,17,4,13,4,0,23.53,23.53
83,109-JAIPUR,170357-Dr. Bansi Dhar School,3,17,0,17,0,0,0,0
84,111-ALLAHABAD/PRAYAGRAJ,210022-Jawahar Navodaya Vidyalaya,4,17,0,17,0,0,0,0
85,121-CHENNAI,190095-Kendriya Vidyalaya,2,17,0,17,0,0,0,0
86,105-CHANDIGARH,050564-M.D.S PUBLIC SCHOOL,4,17,5,12,0,5,29.41,0
87,106-KOCHI,090072-Panchayat H.s.s.,4,17,0,17,0,0,0,0
88,104-GUWAHATI,200013-B.b.institution,5,17,17,0,17,0,100,100
89,114-DEHRADUN,340305-Shishu Vidya Mandir,2,17,0,17,0,0,0,0
90,114-DEHRADUN,210777-Chetna Junior High School,3,17,17,0,17,0,100,100
91,110-PATNA,030313-Marwari +2 Ucchater Vidyalaya,3,17,0,17,0,0,0,0
92,103-KOLKATA,220112-Kendriya Vidyalaya,4,17,0,17,0,0,0,0
93,113-BHOPAL,"100126-Kendriya Vidyalaya, No.2",3,14,0,14,0,0,0,0
94,102-PUNE,110034-Yashwant Vidyapeeth Karad,3,16,6,10,5,1,37.5,31.25
95,105-CHANDIGARH,050646-Army Public School,4,16,11,5,10,1,68.75,62.5
96,107-DELHI,050544-S.D.M PUBLIC SCHOOL ,3,16,16,0,8,8,100,50
97,109-JAIPUR,170296-Abhinav Senior Secondary School,2,16,0,16,0,0,0,0
98,106-KOCHI,M40073-St. John's Public School,3,16,0,16,0,0,0,0
99,120-RANCHI,260190-Star International School,5,16,16,0,0,16,100,0
100,104-GUWAHATI,"240009-Govt. Hr. Sec. School, Khonsa",4,16,4,12,1,3,25,6.25
1,115-BHUBANESWAR,150198-Kerala English Medium School,6,15,12,3,2,10,75,12.5
2,104-GUWAHATI,020062-Sreeram Academy,4,16,7,9,0,7,43.75,0
3,114-DEHRADUN,340140-Moravian Institute,8,15,5,10,0,5,31.25,0
4,105-CHANDIGARH,320202-HRDC Hq 2 Corps,3,16,0,16,0,0,0,0
5,110-PATNA,030413-Shanti Mission Academy,3,16,5,11,3,2,31.25,18.75
6,111-ALLAHABAD/PRAYAGRAJ,210052-Springdale College,3,16,0,16,0,0,0,0
7,105-CHANDIGARH,050069-Nav Bharat High School,3,16,16,0,16,0,100,100
8,106-KOCHI,400027-Vyas Vidya Peethom,4,16,16,0,16,0,100,100
9,114-DEHRADUN,210372-Kendriya Vidyalaya,4,16,0,16,0,0,0,0
10,125-JAMMU,070034-Jawahar Navodaya Vidyalaya,5,16,16,0,11,5,100,68.75
11,113-BHOPAL,100245-St. Paul Convent Hr. Sec. School,3,16,1,15,1,0,6.25,6.25
12,107-DELHI,270536-Khemo Devi Public School,3,16,0,16,0,0,0,0
13,105-CHANDIGARH,M16107-Aaban Public School,3,16,0,16,0,0,0,0
14,107-DELHI,M21561-St. Teresa Open School,3,16,0,16,0,0,0,0
15,109-JAIPUR,170376-Name 4347,3,16,0,16,0,0,0,0
16,103-KOLKATA,220106-Rabindranath Higher Sec. School,3,16,16,0,16,0,100,100
17,109-JAIPUR,170289-Aakansha International School,3,16,0,16,0,0,0,0
18,118-GANDHINAGAR,040036-Shree Amrita Academy Higher,3,16,16,0,16,0,100,100
19,114-DEHRADUN,210614-Gyandeep Higher Secondary School,4,16,0,16,0,0,0,0
20,107-DELHI,270365-Govt.co-education Secondary School,4,16,0,16,0,0,0,0
21,105-CHANDIGARH,050383-Megharam Public School,2,16,0,16,0,0,0,0
22,111-ALLAHABAD/PRAYAGRAJ,210714-Ved Prakash Pathak Public School,3,16,0,16,0,0,0,0
23,114-DEHRADUN,210790-Vibgyor School,4,16,0,16,0,0,0,0
24,113-BHOPAL,100019-Chattrapati Shivaji Sr.sec Public,5,16,0,16,0,0,0,0
25,109-JAIPUR,170403-Maharaja Public Sr. Sec. School,3,16,0,16,0,0,0,0
26,113-BHOPAL,100058-Krishna Higher Sec. School,3,16,0,16,0,0,0,0
27,109-JAIPUR,170152-Govt. Sr. Sec. School,2,16,16,0,0,16,100,0
28,114-DEHRADUN,210254-Divine Inter College,3,16,0,16,0,0,0,0
29,109-JAIPUR,M45090-St. Francis Sr. Sec. School (Tanwar Shikshan Sansthan),3,16,10,6,10,0,62.5,62.5
30,110-PATNA,030116-Kiddy Convent High School,3,16,0,16,0,0,0,0
31,105-CHANDIGARH,160132-Delhi Public School,3,16,0,16,0,0,0,0
32,121-CHENNAI,190159-Anugragha International School,3,16,0,16,0,0,0,0
33,110-PATNA,030375-Jawahar Navodaya Vidyalaya,3,16,5,11,4,1,31.25,25
34,118-GANDHINAGAR,040073-GAJERA INTERNATIONAL SCHOOL,4,16,16,0,6,10,100,37.5
35,107-DELHI,M05446-Iqraa Public School,2,16,0,16,0,0,0,0
36,115-BHUBANESWAR,410115-Centurion Public School,3,15,9,6,5,4,60,33.33
37,105-CHANDIGARH,160128-Anuvarat Public Sr.Sec. School,3,15,0,15,0,0,0,0
38,107-DELHI,050257-Kitty Garden Sr.sec.school,3,15,0,15,0,0,0,0
39,121-CHENNAI,190119-Aristo Public School,4,14,13,1,4,9,86.67,26.67
40,104-GUWAHATI,M13020-Auxilium Umpohliew Jingstad Secondary School,3,15,2,13,0,2,13.33,0
41,110-PATNA,030244-Govt. Girls Higher Secondary School,3,15,13,2,0,13,86.67,0
42,121-CHENNAI,"190086-Kendriya Vidyalaya, Hdf",3,15,0,15,0,0,0,0
43,110-PATNA,030012-Jawahar Navodaya Vidyalaya,4,15,0,15,0,0,0,0
44,123-GANGTOK,180020-Govt. Senior Secondary School,3,15,0,15,0,0,0,0
45,107-DELHI,450073-Katha School Of Entrepreneurship,3,15,0,15,0,0,0,0
46,107-DELHI,270262-Sarvodaya Bal Vidyalaya,1,14,0,14,0,0,0,0
47,121-CHENNAI,M19104-Asian Christian High School,3,15,0,15,0,0,0,0
48,115-BHUBANESWAR,"150182-Zila High School, Puri, Odisha",3,15,7,8,4,3,46.67,26.67
49,111-ALLAHABAD/PRAYAGRAJ,210798-Radha Krishna Memorial Education Centre,3,15,0,15,0,0,0,0
50,121-CHENNAI,190036-Kendriya Vidyalaya,4,15,0,15,0,0,0,0
51,103-KOLKATA,230010-Govt. Rabindra Bangla Vidyalaya,3,15,0,15,0,0,0,0
52,101-HYDERABAD,M01195-Mannu Model School ,4,15,0,15,0,0,0,0
53,111-ALLAHABAD/PRAYAGRAJ,210119-Bal Vidyalaya Madhyamik School,3,15,0,15,0,0,0,0
54,110-PATNA,030194-G.m.s.s. Ucch Vidyalaya,3,15,6,9,5,1,40,33.33
55,105-CHANDIGARH,050351-Bhagwan Parshu Ram Sr.sec. School,3,15,0,15,0,0,0,0
56,111-ALLAHABAD/PRAYAGRAJ,210259-Jan Kalyan Shiksha Samiti,3,15,0,15,0,0,0,0
57,111-ALLAHABAD/PRAYAGRAJ,210525-Hare Krishna Public School,3,15,0,15,0,0,0,0
58,121-CHENNAI,190075-Govt. Girls Hr.sec. School,6,15,0,15,0,0,0,0
59,109-JAIPUR,170434-G.S Jangid Memorial School,2,15,15,0,15,0,100,100
60,113-BHOPAL,100305-Ambedkar Smriti Higher Sec.School,2,15,0,15,0,0,0,0
61,103-KOLKATA,T22003-LUTHFA PRIVATE INDUSTRIAL,3,15,0,15,0,0,0,0
62,110-PATNA,030261-R.b.+2 Inter School,2,15,0,15,0,0,0,0
63,107-DELHI,210520-NIMT B SCHOOL,4,15,0,15,0,0,0,0
64,111-ALLAHABAD/PRAYAGRAJ,210713-R.R. Public School,2,15,0,15,0,0,0,0
65,105-CHANDIGARH,050446-Green Valley Sr. Sec. School,3,15,0,15,0,0,0,0
66,114-DEHRADUN,340023-Jawahar Navodaya Vidyalaya,3,12,0,12,0,0,0,0
67,111-ALLAHABAD/PRAYAGRAJ,210711-Baba Gurukul Academy,2,15,0,15,0,0,0,0
68,110-PATNA,030043-Saraswati Vidya Mandir,3,15,7,8,0,7,46.67,0
69,117-BENGALURU,480004-Spastic Society Of Karnataka,6,15,0,15,0,0,0,0
70,111-ALLAHABAD/PRAYAGRAJ,210554-Study Well Public School,3,15,0,15,0,0,0,0
71,101-HYDERABAD,470186-Kendriya Vidyalaya,4,15,0,15,0,0,0,0
72,120-RANCHI,260034-Neta Ji Subhas Public School,3,15,0,15,0,0,0,0
73,104-GUWAHATI,440002-Rongkut Khorsing High School,3,15,5,10,3,2,33.33,20
74,107-DELHI,270541-Rural Complex For Complete Education (RCCE) Public School,4,14,1,13,0,1,7.14,0
75,111-ALLAHABAD/PRAYAGRAJ,210477-Kamla Higher Secondary School,3,14,0,14,0,0,0,0
76,117-BENGALURU,480002-St. Ann's High School,4,14,0,14,0,0,0,0
77,121-CHENNAI,190043-Little Kingdom School,3,14,0,14,0,0,0,0
78,109-JAIPUR,170442-Shri Krishna Secondary Public School,2,14,0,14,0,0,0,0
79,125-JAMMU,M07051-Sri Guru Govind Singh Public,3,13,4,9,0,4,28.57,0
80,116-VISAKHAPATNAM,010195-Kendriya Vidyalaya,3,14,12,2,0,12,85.71,0
81,113-BHOPAL,M10229-Aaps (ashaskiya The Akshya Academy),3,14,0,14,0,0,0,0
82,118-GANDHINAGAR,390159-Glorious Public School,2,14,14,0,10,4,100,71.43
83,121-CHENNAI,190064-S.l.b. Govt. Hr. Sec. School,3,14,6,8,3,3,42.86,21.43
84,111-ALLAHABAD/PRAYAGRAJ,210126-Rosy School,2,14,0,14,0,0,0,0
85,114-DEHRADUN,210806-LTR Public School,3,14,0,14,0,0,0,0
86,102-PUNE,110108-Kendriya Vidyalaya,3,14,0,14,0,0,0,0
87,102-PUNE,110146-Army Public School,2,14,0,14,0,0,0,0
88,113-BHOPAL,100024-Maharishi Vidya Mandir,1,14,0,14,0,0,0,0
89,107-DELHI,050594-Aakash International School,3,14,0,14,0,0,0,0
90,121-CHENNAI,310012-K S P International Higher Secondary School,3,14,0,14,0,0,0,0
91,110-PATNA,"030063-G.a.inter School,",3,14,0,14,0,0,0,0
92,109-JAIPUR,170019-Kendriya Vidyalaya No-1,3,14,0,14,0,0,0,0
93,102-PUNE,110107-Kendriya Vidyalaya,3,14,3,11,3,0,21.43,21.43
94,109-JAIPUR,170345-Sunrise Sr.sec. Public School,2,14,0,14,0,0,0,0
95,121-CHENNAI,190017-Kennedy Matriculation Higher Sec,2,14,10,4,0,10,71.43,0
96,107-DELHI,M21367-Nm Hr.sec.school,3,14,2,12,0,2,14.29,0
97,107-DELHI,270438-S.d. Saraswati Bal Mandir,2,14,0,14,0,0,0,0
98,104-GUWAHATI,020002-Rupnagar Vidyapeeth High School,3,14,2,12,1,1,14.29,7.14
99,110-PATNA,030262-R.d.h.+2 School,4,13,0,13,0,0,0,0
100,107-DELHI,450177-NOIDA Deaf Society,3,14,2,12,0,2,14.29,0
1,109-JAIPUR,170004-Sophia Sr.hr.sec.school,4,14,12,2,11,1,85.71,78.57
2,111-ALLAHABAD/PRAYAGRAJ,210422-A P S Academy,3,12,0,12,0,0,0,0
3,105-CHANDIGARH,050236-Red Roses Public Sr. Sec. School,3,14,3,11,0,3,21.43,0
4,110-PATNA,030377-Jawahar Navodaya Vidyalaya,3,13,0,13,0,0,0,0
5,105-CHANDIGARH,050520-Datta Public School,3,14,0,14,0,0,0,0
6,106-KOCHI,M40057-Mit Trust English Medium School,3,14,0,14,0,0,0,0
7,118-GANDHINAGAR,040029-Kendriya Vidyalaya,4,14,14,0,14,0,100,100
8,122-DHARAMSALA,060020-Govt. Senior Secondary School,4,14,8,6,0,8,57.14,0
9,101-HYDERABAD,M47185-St. PETERS EDU SCHOOL,3,14,0,14,0,0,0,0
10,125-JAMMU,070060-Army Public School,2,14,0,14,0,0,0,0
11,109-JAIPUR,170111-Nehru Public Sr.sec.school,2,14,0,14,0,0,0,0
12,106-KOCHI,400064-Raja Rajeswari Senior Sec.school,3,14,0,14,0,0,0,0
13,105-CHANDIGARH,050600-Kite International Public School,2,14,0,14,0,0,0,0
14,121-CHENNAI,190140-The Indian Public School,6,13,0,13,0,0,0,0
15,111-ALLAHABAD/PRAYAGRAJ,210415-Jawahar Navodaya Vidyalaya,6,13,0,13,0,0,0,0
16,125-JAMMU,M38320-Muslim Institute Of Education,2,13,0,13,0,0,0,0
17,119-RAIPUR,290047-Kendriya Vidyalaya,3,13,0,13,0,0,0,0
18,120-RANCHI,260130-K.n. +2 High School,2,13,0,13,0,0,0,0
19,114-DEHRADUN,210636-S.b.d.m. Intermediate College,3,13,0,13,0,0,0,0
20,123-GANGTOK,180007-Himalayan Pharmecy Institute,3,13,13,0,12,1,100,92.31
21,106-KOCHI,090083-Holy Trinity School,4,13,0,13,0,0,0,0
22,105-CHANDIGARH,050116-Mamta Girls Senior Secondary School,3,13,0,13,0,0,0,0
23,120-RANCHI,260201-CHHOTA NAGPUR INTER COLLEGE,3,13,0,13,0,0,0,0
24,105-CHANDIGARH,050535-Guru Dronacharya Public School,3,13,0,13,0,0,0,0
25,105-CHANDIGARH,160140-Chopra Public School,3,13,13,0,13,0,100,100
26,122-DHARAMSALA,060077-Jawahar Navodaya Vidyalaya,3,13,0,13,0,0,0,0
27,109-JAIPUR,170362-Alpha Public Senior Sec. School,3,13,0,13,0,0,0,0
28,105-CHANDIGARH,050246-S. K. Sr. Sec School,2,13,0,13,0,0,0,0
29,114-DEHRADUN,340106-Govt. Inter College,4,13,13,0,13,0,100,100
30,107-DELHI,"270386-D.c.convent Secondary School,",3,13,0,13,0,0,0,0
31,114-DEHRADUN,340275-Super Inter College,2,13,13,0,0,13,100,0
32,111-ALLAHABAD/PRAYAGRAJ,210154-D.K.Inter College,3,13,0,13,0,0,0,0
33,121-CHENNAI,190123-Kendriya Vidyalaya,3,13,13,0,3,10,100,23.08
34,120-RANCHI,260119-+2 J.k. High School,2,13,0,13,0,0,0,0
35,104-GUWAHATI,"M02042-Montfort High School, Chabua",3,13,6,7,3,3,46.15,23.08
36,105-CHANDIGARH,160031-St.soldiers Inter College,5,13,4,9,0,4,30.77,0
37,102-PUNE,TM2801-Montfort Industrial Training Institute,2,13,0,13,0,0,0,0
38,114-DEHRADUN,340273-Govt. Inter College,3,13,13,0,13,0,100,100
39,114-DEHRADUN,340018-Jawahar Navodaya Vidyalaya,3,13,0,13,0,0,0,0
40,120-RANCHI,320608-HQ 10 Corps Hrdc,3,13,0,13,0,0,0,0
41,114-DEHRADUN,210764-S.K.D Public School,1,12,0,12,0,0,0,0
42,105-CHANDIGARH,160076-Jawahar Navodaya Vidyalaya,1,12,0,12,0,0,0,0
43,113-BHOPAL,100124-Kendriya Vidyalaya,3,12,0,12,0,0,0,0
44,105-CHANDIGARH,J16007-Central Jail,3,12,0,12,0,0,0,0
45,107-DELHI,050611-M D Senior Secondary School,1,12,0,12,0,0,0,0
46,110-PATNA,030199-B S S Conigaite +2 School,3,12,0,12,0,0,0,0
47,102-PUNE,110116-Jawahar Navodaya Vidyalaya,3,12,0,12,0,0,0,0
48,114-DEHRADUN,340224-Govt. Junior College,2,12,0,12,0,0,0,0
49,111-ALLAHABAD/PRAYAGRAJ,210728-B.G.B. Braj Education Academy,2,12,0,12,0,0,0,0
50,105-CHANDIGARH,050510-Brahmi Janta Sr. Sec. School,2,12,0,12,0,0,0,0
51,111-ALLAHABAD/PRAYAGRAJ,"M21296-Milton Public School,",3,12,6,6,3,3,50,25
52,109-JAIPUR,170408-Dahdimati International Sr. Sec. School,3,12,0,12,0,0,0,0
53,120-RANCHI,260029-Sido Kohhu High School,2,12,0,12,0,0,0,0
54,120-RANCHI,260147-+2 Govt. Girls High School,2,12,0,12,0,0,0,0
55,114-DEHRADUN,M34239-Rehmania Inter College,2,12,12,0,0,12,100,0
56,105-CHANDIGARH,050388-Apex Public School,2,12,0,12,0,0,0,0
57,107-DELHI,050643-Fogaat Public Sr. Sec. School,3,12,0,12,0,0,0,0
58,113-BHOPAL,100031-Maharishi Vidya Mandir,3,12,0,12,0,0,0,0
59,117-BENGALURU,"320410-Hrdc, Hq K&k Sub Area,",2,12,0,12,0,0,0,0
60,109-JAIPUR,170156-Govt. Sr. Sec. School,3,12,0,12,0,0,0,0
61,115-BHUBANESWAR,"150193-Kendriya Vidyalaya, Bhadrak",3,12,12,0,7,5,100,58.33
62,110-PATNA,030192-Kajariwal Ucch Vidyalaya,3,12,0,12,0,0,0,0
63,121-CHENNAI,190113-PADMASUBRAMANIAM BALABHAVAN,3,12,12,0,11,1,100,91.67
64,105-CHANDIGARH,050192-Shiv High School,2,12,0,12,0,0,0,0
65,102-PUNE,110144-Fravashi International Academy,3,12,0,12,0,0,0,0
66,103-KOLKATA,M22094-Belur T.h. Memorial Urdu Higher,3,12,0,12,0,0,0,0
67,111-ALLAHABAD/PRAYAGRAJ,210576-Green Field Academy Sr.sec. School,2,12,0,12,0,0,0,0
68,103-KOLKATA,450178-North Bengal Central School,2,12,12,0,6,6,100,50
69,115-BHUBANESWAR,150081-Jawahar Navodaya Vidyalaya,3,12,10,2,5,5,83.33,41.67
70,113-BHOPAL,M38256-Madarsa Hazrat Bilal,1,12,0,12,0,0,0,0
71,118-GANDHINAGAR,390076-Sardar Public School,2,12,12,0,12,0,100,100
72,123-GANGTOK,180014-Govt. Senior Secondary School,1,12,12,0,4,8,100,33.33
73,120-RANCHI,"450175-Deepsikha, ICD & MH",2,12,0,12,0,0,0,0
74,114-DEHRADUN,210570-Mother India Inter College,3,12,12,0,12,0,100,100
75,111-ALLAHABAD/PRAYAGRAJ,210482-Kendriya Vidyalaya,2,11,0,11,0,0,0,0
76,121-CHENNAI,190031-Kendriya Vidyalaya,3,12,0,12,0,0,0,0
77,114-DEHRADUN,340306-Raiwal Mil Station,3,12,0,12,0,0,0,0
78,122-DHARAMSALA,"060050-Jai Him Nav Jyoti Sr. Sec. School,",2,12,0,12,0,0,0,0
79,114-DEHRADUN,210201-Rajani Public School,3,12,0,12,0,0,0,0
80,109-JAIPUR,170092-Kendriya Vidyalaya,2,12,0,12,0,0,0,0
81,113-BHOPAL,100007-Kendriya Vidyalaya,3,12,2,10,2,0,16.67,16.67
82,104-GUWAHATI,130026-Ramakrishna Mission Hr.Sec. School,2,12,6,6,1,5,50,8.33
83,122-DHARAMSALA,M06001-New Crescent Sr.sec. School,3,12,0,12,0,0,0,0
84,102-PUNE,110118-Jawahar Navodaya Vidyalaya,2,11,4,7,4,0,36.36,36.36
85,114-DEHRADUN,M38312-Rehmania Inter College,2,11,11,0,0,11,100,0
86,121-CHENNAI,190155-KSR Akshara Academy,3,11,0,11,0,0,0,0
87,107-DELHI,050614-Shaheed Amar Singh Public School,3,11,0,11,0,0,0,0
88,122-DHARAMSALA,060013-Govt. Sr. Sec. School,2,11,0,11,0,0,0,0
89,120-RANCHI,260112-+2 High School,2,11,0,11,0,0,0,0
90,117-BENGALURU,080010-Divya Shanti High School,3,11,0,11,0,0,0,0
91,107-DELHI,210727-Vidhan Public School,2,11,0,11,0,0,0,0
92,102-PUNE,110063-J B Ludhani High School & Jr Colleg,3,11,0,11,0,0,0,0
93,114-DEHRADUN,340269-Govt. Inter College,2,11,0,11,0,0,0,0
94,118-GANDHINAGAR,040039-Nootan Bharti Vidyalaya,2,11,11,0,5,6,100,45.45
95,102-PUNE,110147-Army Public School,2,11,0,11,0,0,0,0
96,113-BHOPAL,100109-Saraswati Gyan Mandir High School,2,9,0,9,0,0,0,0
97,104-GUWAHATI,020071-Kampur Adarsha High School,3,11,2,9,0,2,18.18,0
98,107-DELHI,"270391-Raghubir Singh Modern School,",2,11,0,11,0,0,0,0
99,111-ALLAHABAD/PRAYAGRAJ,210721-Sacred Heart School,2,11,0,11,0,0,0,0
100,114-DEHRADUN,210617-Doon Hills Academy,2,11,0,11,0,0,0,0
1,123-GANGTOK,220063-Goethal Memorial School,2,11,11,0,6,5,100,54.55
2,118-GANDHINAGAR,040063-Savvy International School,2,11,11,0,11,0,100,100
3,101-HYDERABAD,470211-JAIN HERITAGE A CAMBRIDGE SCHOOL ,2,10,0,10,0,0,0,0
4,118-GANDHINAGAR,040133-Shri V D Mayavanshi High School,2,11,11,0,4,7,100,36.36
5,111-ALLAHABAD/PRAYAGRAJ,210032-Kendriya Vidyalaya,2,11,0,11,0,0,0,0
6,111-ALLAHABAD/PRAYAGRAJ,M21472-Alpsankhyak Aqsa Public Inter,2,9,0,9,0,0,0,0
7,114-DEHRADUN,M21661-Delhi Public Global School,2,11,0,11,0,0,0,0
8,117-BENGALURU,080062-Sri Adichundhangiri Eng.High School,4,11,0,11,0,0,0,0
9,113-BHOPAL,100011-Kendriya Vidyalaya No.1,2,11,0,11,0,0,0,0
10,105-CHANDIGARH,050565-GLOBAL PUBLIC SCHOOL,2,11,0,11,0,0,0,0
11,102-PUNE,450006-A.j.n.inst.of Hearing Handicapped,2,10,0,10,0,0,0,0
12,105-CHANDIGARH,050134-Dewan Bal Krishan Public School,3,11,0,11,0,0,0,0
13,103-KOLKATA,220126-Ramkrishna Vedanta Ashram Vidyamandir,2,11,0,11,0,0,0,0
14,111-ALLAHABAD/PRAYAGRAJ,M21625-St. Mary's Convent Inter College,2,11,0,11,0,0,0,0
15,109-JAIPUR,170176-Swatantrata Sainani Chiranji Lal,2,11,0,11,0,0,0,0
16,105-CHANDIGARH,050519-Gayatri Public School,2,11,0,11,0,0,0,0
17,107-DELHI,050618-JCM International School,2,11,0,11,0,0,0,0
18,101-HYDERABAD,320417-Hq 54 Inf Div,2,11,0,11,0,0,0,0
19,110-PATNA,"030072-B.p.ucch Vidyalaya,",3,11,0,11,0,0,0,0
20,110-PATNA,030042-Adwaita Mission High School,2,11,6,5,6,0,54.55,54.55
21,114-DEHRADUN,340213-Govt. Inter College,3,11,0,11,0,0,0,0
22,109-JAIPUR,170370-Vidhya Sagar School,2,10,0,10,0,0,0,0
23,107-DELHI,450108-The Ashtavakra School (school For,2,10,10,0,10,0,100,100
24,120-RANCHI,260073-DAV Public School,3,10,0,10,0,0,0,0
25,107-DELHI,270482-James Convent School,1,10,0,10,0,0,0,0
26,116-VISAKHAPATNAM,010199-Vinayaka High School,2,10,8,2,0,8,80,0
27,104-GUWAHATI,120058-Christian Model English Higher Secondary School,1,10,2,8,0,2,20,0
28,113-BHOPAL,M10264-Amreen Higher Secondary School,2,10,0,10,0,0,0,0
29,114-DEHRADUN,M21230-F.d Islamia Inter College,2,10,0,10,0,0,0,0
30,105-CHANDIGARH,050597-Lord Krishna Public School,2,10,0,10,0,0,0,0
31,121-CHENNAI,190085-Kandriya Vidyalaya,2,10,0,10,0,0,0,0
32,109-JAIPUR,170022-Kendriya Vidyalaya,2,10,0,10,0,0,0,0
33,110-PATNA,030254-K.r.k.high School,2,10,0,10,0,0,0,0
34,114-DEHRADUN,340300-Govt. Inter College,2,10,0,10,0,0,0,0
35,105-CHANDIGARH,160098-Guru Teg Bahadur Public School,2,10,0,10,0,0,0,0
36,109-JAIPUR,170106-Veer Teja Siksha Samiti Sr.sec.,2,10,0,10,0,0,0,0
37,104-GUWAHATI,M02066-CENTRAL PUBLIC SCHOOL,1,10,2,8,2,0,20,20
38,109-JAIPUR,M17273-Hazrat Omar Bin Kattab Pvt. ITI,1,10,0,10,0,0,0,0
39,109-JAIPUR,170292-Shiksha High School,2,10,0,10,0,0,0,0
40,116-VISAKHAPATNAM,010182-Sri Pragathi Junior College,2,10,10,0,0,10,100,0
41,114-DEHRADUN,220127-Pearl Rosary School (New),1,10,8,2,2,6,80,20
42,104-GUWAHATI,440011-Pranab Jubilee College,3,10,3,7,3,0,30,30
43,114-DEHRADUN,M38369-Pragati Senior Secondary School,1,10,0,10,0,0,0,0
44,113-BHOPAL,320413-21 Corps Hrdc,1,10,0,10,0,0,0,0
45,121-CHENNAI,420006-Maharishi Vidya Mandir Senior,2,10,0,10,0,0,0,0
46,105-CHANDIGARH,050357-Modern Senior Secondary School,2,10,0,10,0,0,0,0
47,107-DELHI,050213-Navodaya Saraswati School,2,10,10,0,10,0,100,100
48,122-DHARAMSALA,060034-Govt. Senior Secondary School,1,10,0,10,0,0,0,0
49,115-BHUBANESWAR,450114-Social Welfare Agency & Training,1,10,10,0,6,4,100,60
50,111-ALLAHABAD/PRAYAGRAJ,M21503-Safa Shariat College,1,10,0,10,0,0,0,0
51,107-DELHI,050528-Swamy Dharmanand Sr.Sec. School,3,10,0,10,0,0,0,0
52,119-RAIPUR,290099-Govt. Model Ramanuj Hr. Sec.school,2,10,0,10,0,0,0,0
53,123-GANGTOK,220101-Kendriya Vidyalaya,2,10,10,0,10,0,100,100
54,107-DELHI,270550-R K Memorial Public School,1,10,0,10,0,0,0,0
55,110-PATNA,030252-Rajkiya Chapman Balika(10+2)school,2,10,0,10,0,0,0,0
56,109-JAIPUR,170304-Rajasthan Public Sr.sec. School,2,10,0,10,0,0,0,0
57,125-JAMMU,M07024-New Horizon Institute Of Secondary,2,10,0,10,0,0,0,0
58,106-KOCHI,090025-K S Abdullah English Medium School,2,10,0,10,0,0,0,0
59,120-RANCHI,260127-Jharia Raj +2 High School,1,10,0,10,0,0,0,0
60,107-DELHI,270373-Kalawati Vidya Bharti Public School,2,10,10,0,8,2,100,80
61,115-BHUBANESWAR,"410035-410035-Govt.(SSD) High School, Dabugam",1,10,4,6,4,0,40,40
62,105-CHANDIGARH,160119-Shri Guru Arjan  Dev Sr.sec. School,2,10,0,10,0,0,0,0
63,109-JAIPUR,450152-Pratham Education Foundation,2,10,9,1,0,9,90,0
64,111-ALLAHABAD/PRAYAGRAJ,210794-Shri Mahipal Shastri Inter College,2,10,0,10,0,0,0,0
65,113-BHOPAL,100068-Mahavir Singh Higher Sec. School,1,10,6,4,6,0,60,60
66,110-PATNA,030007-Jawahar Navodaya Vidyalaya,1,10,0,10,0,0,0,0
67,107-DELHI,270488-Lavi Public School,1,10,0,10,0,0,0,0
68,121-CHENNAI,420110-DAV Boys Sr. Secondary School,2,10,0,10,0,0,0,0
69,105-CHANDIGARH,050424-C.r.b.v.m.senior Secondary School,2,10,0,10,0,0,0,0
70,119-RAIPUR,290088-Govt. Boys Higher Secondary School,1,10,0,10,0,0,0,0
71,105-CHANDIGARH,050200-Evergreen High School,1,10,0,10,0,0,0,0
72,109-JAIPUR,170142-Govt. Sr.sec. School,2,10,0,10,0,0,0,0
73,115-BHUBANESWAR,150095-Govt. High School,1,10,4,6,2,2,40,20
74,115-BHUBANESWAR,410124-Jawahar Navodaya Vidyalaya,3,10,8,2,7,1,80,70
75,118-GANDHINAGAR,040035-Atul Vidyalaya,2,10,10,0,5,5,100,50
76,115-BHUBANESWAR,410002-Daniel Public School,1,10,4,6,2,2,40,20
77,103-KOLKATA,180015-Govt. Senior Secondary School,2,10,10,0,10,0,100,100
78,121-CHENNAI,190124-Brilliant School,2,10,0,10,0,0,0,0
79,109-JAIPUR,170118-Defence Public Senior Secondary,2,10,0,10,0,0,0,0
80,116-VISAKHAPATNAM,450171-New Sunflower Special School,2,10,9,1,1,8,90,10
81,111-ALLAHABAD/PRAYAGRAJ,210745-K.V.N. Public School,3,10,10,0,10,0,100,100
82,105-CHANDIGARH,050498-Nav Chetna Senior Secondary School,2,10,0,10,0,0,0,0
83,118-GANDHINAGAR,040092-Shree Swaminarayan International Gunatit Vidyadham,2,10,10,0,6,4,100,60
84,113-BHOPAL,M10089-Bright Star Hr.sec.school,2,10,0,10,0,0,0,0
85,121-CHENNAI,450174-National  Institute For Empowerment with Multiple Disabilities,2,10,0,10,0,0,0,0
86,115-BHUBANESWAR,150204-Dronacharya School,2,10,4,6,4,0,40,40
87,121-CHENNAI,190073-Govt. Girls Hr.sec. School,1,10,0,10,0,0,0,0
88,121-CHENNAI,190014-Shree Vidyalaya Mat.Hr.Sec.School,2,10,0,10,0,0,0,0
89,111-ALLAHABAD/PRAYAGRAJ,210071-Kendriya Vidyalaya,2,10,0,10,0,0,0,0
90,109-JAIPUR,170151-Govt. Sr. Sec. School,2,10,0,10,0,0,0,0
91,111-ALLAHABAD/PRAYAGRAJ,320606-HQ 33 Armd Div,2,10,0,10,0,0,0,0
92,109-JAIPUR,170136-Lady Anusuya Singhania Educational,1,10,0,10,0,0,0,0
93,107-DELHI,210673-K.C.S. Public Inter College,2,10,0,10,0,0,0,0
94,111-ALLAHABAD/PRAYAGRAJ,210740-Cross Belly International School,2,10,0,10,0,0,0,0
95,105-CHANDIGARH,050227-Cr Sr. Sec. School,2,10,0,10,0,0,0,0
96,117-BENGALURU,V08001-Arundhati Gurukulam,1,10,0,10,0,0,0,0
97,106-KOCHI,M40056-Noorul Huda Orphanage,2,10,0,10,0,0,0,0
98,120-RANCHI,260167-S.s.+2 High School,2,10,0,10,0,0,0,0
99,105-CHANDIGARH,160029-St. Soldier Divine Public School,2,10,1,9,0,1,10,0
100,118-GANDHINAGAR,040027-Kendriya Vidyalaya,2,10,10,0,6,4,100,60
1,114-DEHRADUN,340317-Seedling School,2,10,0,10,0,0,0,0
2,116-VISAKHAPATNAM,010207-Vani Junior College,2,10,9,1,0,9,90,0
3,103-KOLKATA,M38112-Belur T.h. Memorial Urdu Higher,4,10,0,10,0,0,0,0
4,120-RANCHI,260132-N.r. Govt. +2 H/s,2,10,0,10,0,0,0,0
5,121-CHENNAI,420093-Adhiparasakthi Annai Illam,2,10,0,10,0,0,0,0
6,111-ALLAHABAD/PRAYAGRAJ,210058-Annie Besant School,2,10,0,10,0,0,0,0
7,105-CHANDIGARH,050043-Kamla Montessori School,2,9,0,9,0,0,0,0
8,114-DEHRADUN,M21308-Muslima Girls Inter College,3,9,0,9,0,0,0,0
9,121-CHENNAI,190173-Tagore Senior Secondary School,2,9,0,9,0,0,0,0
10,105-CHANDIGARH,050547-Rao Ramchander Memorial Public Sch.,2,9,0,9,0,0,0,0
11,116-VISAKHAPATNAM,010121-N. V. R. Junior College,2,9,6,3,0,6,66.67,0
12,109-JAIPUR,170410-Bhagwani Devi Shikshan Sansthan,2,9,0,9,0,0,0,0
13,107-DELHI,"G27022-GOVT. BOYS SR. SEC. SCHOOL,NEAR UDYOG NAGAR METRO STATION, CAMP NO.-4 JWALAPURI NEW DELHI-87",2,5,1,4,0,1,11.11,0
14,109-JAIPUR,170264-Maharishi Dayanand Public School,2,9,0,9,0,0,0,0
15,105-CHANDIGARH,160101-Mother India Public School,2,9,0,9,0,0,0,0
16,118-GANDHINAGAR,040056-Bansidhar Vidyalaya,2,9,9,0,8,1,100,88.89
17,105-CHANDIGARH,050393-St. Paul Bharti School,2,9,0,9,0,0,0,0
18,103-KOLKATA,220097-Modella Caretaker Centre & School,2,9,0,9,0,0,0,0
19,102-PUNE,110031-Montfort Higher Sec. School,2,9,0,9,0,0,0,0
20,121-CHENNAI,190134-BVM GLOBAL BOLLINENI HILLSIDE SENIOR SECONDARY SCHOOL,2,9,8,1,2,6,88.89,22.22
21,109-JAIPUR,170165-Govt. Higher Sec. School,2,9,0,9,0,0,0,0
22,101-HYDERABAD,470023-P R R Jr. College,3,8,0,8,0,0,0,0
23,119-RAIPUR,290171-Adwani Oerlikon Govt. H.S. School,3,9,0,9,0,0,0,0
24,120-RANCHI,260089-Jawahar Navodaya Vidyalaya,2,9,0,9,0,0,0,0
25,110-PATNA,030010-Jawahar Navodaya Vidyalaya,2,9,0,9,0,0,0,0
26,107-DELHI,270475-Gyan Jyoti Public School,2,9,1,8,0,1,11.11,0
27,111-ALLAHABAD/PRAYAGRAJ,210159-Dr.amrit Lal Ishrat,2,9,9,0,9,0,100,100
28,105-CHANDIGARH,050269-L.c.r.t Public School,2,9,0,9,0,0,0,0
29,105-CHANDIGARH,160093-Sidana International School,2,9,0,9,0,0,0,0
30,109-JAIPUR,M17271-Al Suffah Academy Public School,2,9,0,9,0,0,0,0
31,111-ALLAHABAD/PRAYAGRAJ,M21286-St. Jude's Inter College,2,9,0,9,0,0,0,0
32,111-ALLAHABAD/PRAYAGRAJ,210432-Jawahar Navodaya Vidyalaya,2,9,0,9,0,0,0,0
33,113-BHOPAL,100022-Jawahar Navodaya Vidyalaya,2,9,0,9,0,0,0,0
34,105-CHANDIGARH,050656-National Sr. Sec. School,2,9,0,9,0,0,0,0
35,109-JAIPUR,170153-Govt. Hr. Sec. School,2,9,0,9,0,0,0,0
36,107-DELHI,270248-Bharat National Public School,2,9,0,9,0,0,0,0
37,104-GUWAHATI,M02075-Adarsha Vidyapith Beluguri,2,9,2,7,2,0,22.22,22.22
38,114-DEHRADUN,340125-Govt. Inter College,3,9,0,9,0,0,0,0
39,114-DEHRADUN,340184-Sateswary Devi Memorial Public School,2,9,0,9,0,0,0,0
40,111-ALLAHABAD/PRAYAGRAJ,210656-Morning Star Children's Academy,2,9,0,9,0,0,0,0
41,115-BHUBANESWAR,150188-Centurion Public School,2,9,6,3,2,4,66.67,22.22
42,105-CHANDIGARH,160161-Atma Ram Memorial Convent School,2,9,0,9,0,0,0,0
43,107-DELHI,380013-Azad Memorial Inter College,2,9,0,9,0,0,0,0
44,102-PUNE,M36147-St.paul's English School&jr.college,2,9,5,4,5,0,55.56,55.56
45,105-CHANDIGARH,050530-Maharishi International Public Sch.,2,9,0,9,0,0,0,0
46,105-CHANDIGARH,M16102-Sant Baba Attar Singh Public School,2,9,0,9,0,0,0,0
47,114-DEHRADUN,340234-Govt. Inter College,2,9,0,9,0,0,0,0
48,106-KOCHI,M09095-A.u.p. School,2,9,0,9,0,0,0,0
49,102-PUNE,M36123-St. Ursula High School,2,9,1,8,0,1,11.11,0
50,121-CHENNAI,420101-Blossom Public School,2,9,0,9,0,0,0,0
51,103-KOLKATA,220102-Kendriya Vidyalaya,2,9,0,9,0,0,0,0
52,120-RANCHI,260038-B.n.saha D.a.v. Public School,2,9,0,9,0,0,0,0
53,104-GUWAHATI,200030-Manughat Class Xii School,2,9,2,7,1,1,22.22,11.11
54,121-CHENNAI,190051-Govt. Higher Sec. School,2,9,0,9,0,0,0,0
55,119-RAIPUR,290141-Govt. Higher Secondary School,2,9,0,9,0,0,0,0
56,121-CHENNAI,420100-Navalar Nedunchezhian Govt.Hr.Sec.School,2,9,0,9,0,0,0,0
57,121-CHENNAI,420112-Sri Sankara Vidyalaya Mat. Hr. Sec. School,2,9,3,6,0,3,33.33,0
58,121-CHENNAI,420111-Selvam Matriculation Hr. secondary School,1,8,0,8,0,0,0,0
59,105-CHANDIGARH,050483-Paramount Senior Secondary School,1,8,0,8,0,0,0,0
60,109-JAIPUR,170282-Adinath Senior Sec. Public School,1,4,0,4,0,0,0,0
61,111-ALLAHABAD/PRAYAGRAJ,"320306-Hrdc, 11 Gorkha Rifles Regimental",1,8,0,8,0,0,0,0
62,118-GANDHINAGAR,040026-Kendriya Vidyalaya,2,6,6,0,4,2,75,50
63,105-CHANDIGARH,160152-Cambridge Convent High School,2,8,0,8,0,0,0,0
64,102-PUNE,110150-Orchids The International School,2,8,0,8,0,0,0,0
65,105-CHANDIGARH,050661-Sarvodaya Public School,1,8,0,8,0,0,0,0
66,109-JAIPUR,M17275-MEWAT ACADEMY OF SCHOOL EDUCATION,1,8,0,8,0,0,0,0
67,121-CHENNAI,190170-Vivekananda Vision School,2,8,0,8,0,0,0,0
68,107-DELHI,M21662-AYESHA PUBLIC SCHOOL,2,8,0,8,0,0,0,0
69,121-CHENNAI,190105-Mathagondapalli Model School,2,8,8,0,6,2,100,75
70,111-ALLAHABAD/PRAYAGRAJ,210532-Jawahar Navodaya Vidyalaya,2,8,0,8,0,0,0,0
71,109-JAIPUR,170421-Akash Science Academy Sr. Sec. School,2,8,0,8,0,0,0,0
72,111-ALLAHABAD/PRAYAGRAJ,210597-Kendriya Vidyalaya,1,4,0,4,0,0,0,0
73,113-BHOPAL,100173-Adarsh Adivasi High School,2,8,0,8,0,0,0,0
74,120-RANCHI,260025-Ramakrishna Mission English School,2,8,0,8,0,0,0,0
75,111-ALLAHABAD/PRAYAGRAJ,210680-Urmil Unique Central Academy,2,8,7,1,6,1,87.5,75
76,123-GANGTOK,180018-Govt. Senior Secondary School,3,8,8,0,7,1,100,87.5
77,121-CHENNAI,190149-Avtar Public School,1,8,0,8,0,0,0,0
78,120-RANCHI,M26188-HOLY CROSS SCHOOL,2,8,0,8,0,0,0,0
79,118-GANDHINAGAR,040050-Kendriya Vidyalaya,4,8,8,0,5,3,100,62.5
80,109-JAIPUR,170418-Mata Shravani International School,1,8,0,8,0,0,0,0
81,105-CHANDIGARH,050507-Ch. Neki Ram Public School,1,8,0,8,0,0,0,0
82,118-GANDHINAGAR,390080-Saurabh English School,2,8,8,0,8,0,100,100
83,109-JAIPUR,170141-Govt. Sr.sec.school,2,8,0,8,0,0,0,0
84,117-BENGALURU,080030-Kendriya Vidalaya,3,8,0,8,0,0,0,0
85,118-GANDHINAGAR,040062-M.B. Patel Gyanjot Vidhya Vihar,1,6,6,0,5,1,75,62.5
86,103-KOLKATA,220047-Kendriya Vidyalaya No. 2,2,8,0,8,0,0,0,0
87,105-CHANDIGARH,050171-Asha High School,1,8,0,8,0,0,0,0
88,107-DELHI,270363-Govt. Sarvodaya Bal Vidyalaya,1,8,0,8,0,0,0,0
89,119-RAIPUR,290151-Govt. Hr.sec. School,1,8,0,8,0,0,0,0
90,110-PATNA,030246-Govt.girls Higher Secondary School,2,8,0,8,0,0,0,0
91,119-RAIPUR,M29158-Oriental Public School,1,8,0,8,0,0,0,0
92,121-CHENNAI,310001-Kendriya Vidyalaya,3,8,0,8,0,0,0,0
93,104-GUWAHATI,M14025-Little Flower Higher Secondary,2,8,8,0,8,0,100,100
94,114-DEHRADUN,210679-Loyal Public School,3,8,0,8,0,0,0,0
95,105-CHANDIGARH,050667-Northern International School,2,8,0,8,0,0,0,0
96,111-ALLAHABAD/PRAYAGRAJ,210059-Mahanagar Boys Inter College,2,8,0,8,0,0,0,0
97,111-ALLAHABAD/PRAYAGRAJ,210179-Shri Sunil Kumar Shiksha Inter collage,3,8,0,8,0,0,0,0
98,105-CHANDIGARH,050581-MAA BHAGWATI NIKETAN PUBLIC SCHOOL,1,5,0,5,0,0,0,0
99,113-BHOPAL,100294-Anupama Higher Secondary School,4,8,0,8,0,0,0,0
100,102-PUNE,360122-Sri Ma Vidyalaya Patlipada,2,7,0,7,0,0,0,0
1,106-KOCHI,T09001-Govt. ITI Kalamassery,4,8,0,8,0,0,0,0
2,101-HYDERABAD,470158-Jawahar Navodaya Vidyalaya,1,8,0,8,0,0,0,0
3,114-DEHRADUN,M21642-Meerut Girls Inter College,1,7,0,7,0,0,0,0
4,104-GUWAHATI,200026-Marachara Class Xii School,2,7,1,6,1,0,14.29,14.29
5,113-BHOPAL,100291-Hitkari Hr.sec. School,2,7,0,7,0,0,0,0
6,106-KOCHI,090008-Bharata Mata College,3,7,0,7,0,0,0,0
7,121-CHENNAI,190171-Shrine vailankanni Sr. Sec. School,3,7,0,7,0,0,0,0
8,108-ABROAD/NIOS HQ,950024-The Indian Community School,2,7,0,7,0,0,0,0
9,120-RANCHI,260148-Govt. High School,2,7,5,2,1,4,71.43,14.29
10,118-GANDHINAGAR,390109-Govt. Sec. & Hr. Sec. School,2,7,7,0,6,1,100,85.71
11,102-PUNE,M38212-Anglo Urdu Boys High School & Jr,2,7,5,2,3,2,71.43,42.86
12,109-JAIPUR,170321-New Adarsh Senior Secondary School,1,7,0,7,0,0,0,0
13,121-CHENNAI,190061-Ici Govt. Hr. Sec. School,1,7,0,7,0,0,0,0
14,107-DELHI,050102-Navyug High School,1,7,7,0,7,0,100,100
15,118-GANDHINAGAR,040052-Gangadhara High School,1,7,7,0,7,0,100,100
16,114-DEHRADUN,210725-J.P. Academy Public School,1,7,7,0,7,0,100,100
17,114-DEHRADUN,340242-Govt. Inter College,2,7,0,7,0,0,0,0
18,107-DELHI,270420-Dhanpatmal Virmani Sr.sec.school,1,7,0,7,0,0,0,0
19,122-DHARAMSALA,060063-Shivalik Public Sr.sec.school,1,7,0,7,0,0,0,0
20,122-DHARAMSALA,060024-Sanjay Gandhi Public Sr.sec School,1,6,0,6,0,0,0,0
21,114-DEHRADUN,210720-Aarti Memorial Sr.Sec.Public School,3,7,0,7,0,0,0,0
22,114-DEHRADUN,340240-Tibetan Homes School,2,7,0,7,0,0,0,0
23,114-DEHRADUN,210211-Vanasthali Public Sr.sec. School,1,7,0,7,0,0,0,0
24,111-ALLAHABAD/PRAYAGRAJ,210106-Kids Corner Happy Sr. Sec. School,1,7,0,7,0,0,0,0
25,109-JAIPUR,170099-Kendriya Vidyalaya,1,6,0,6,0,0,0,0
26,121-CHENNAI,190054-Govt. Higher Secondary School,1,6,0,6,0,0,0,0
27,122-DHARAMSALA,060051-J.c.b. Public Sr.sec.publilc School,2,7,0,7,0,0,0,0
28,103-KOLKATA,180005-Fiveways School,2,7,7,0,3,4,100,42.86
29,115-BHUBANESWAR,150054-Ekalavya Model Residential School,2,7,3,4,2,1,42.86,28.57
30,104-GUWAHATI,020066-Name 5178,2,7,1,6,1,0,14.29,14.29
31,111-ALLAHABAD/PRAYAGRAJ,M21391-Global Oriental School,2,7,0,7,0,0,0,0
32,109-JAIPUR,170150-Govt. Hr. Sec. School,2,7,0,7,0,0,0,0
33,111-ALLAHABAD/PRAYAGRAJ,320604-Hq 4 Rapid,1,7,0,7,0,0,0,0
34,125-JAMMU,070043-Jawahar Navodaya Vidyalaya,1,7,0,7,0,0,0,0
35,118-GANDHINAGAR,390125-Radhe International School,1,7,7,0,6,1,100,85.71
36,105-CHANDIGARH,050402-New Pragati Senior Secondary School,2,7,0,7,0,0,0,0
37,121-CHENNAI,190046-Govt. Girls Hr. Sec. School,2,7,0,7,0,0,0,0
38,106-KOCHI,M09061-Noorul Huda Orphanage,1,6,0,6,0,0,0,0
39,102-PUNE,360109-Bharti Sanskrit Vidya Niketaram,1,6,0,6,0,0,0,0
40,110-PATNA,030028-Kendriya Vidyalaya No.-2,2,6,0,6,0,0,0,0
41,111-ALLAHABAD/PRAYAGRAJ,210780-M G International School,1,6,0,6,0,0,0,0
42,122-DHARAMSALA,060100-Army Public School,1,6,4,2,0,4,66.67,0
43,109-JAIPUR,M38272-Maulana Abul Kalam Azad Muslim,1,6,0,6,0,0,0,0
44,118-GANDHINAGAR,040104-P. Chandra International School,2,6,6,0,2,4,100,33.33
45,111-ALLAHABAD/PRAYAGRAJ,210735-R.S. Convent Sainik School,1,6,0,6,0,0,0,0
46,107-DELHI,270414-Muni International School,1,6,0,6,0,0,0,0
47,115-BHUBANESWAR,410114-Ravenshaw Collegiate School,1,6,3,3,2,1,50,33.33
48,105-CHANDIGARH,160126-R.P. International Sr.Sec. School,1,6,0,6,0,0,0,0
49,113-BHOPAL,100002-Asha Kala Kendra,1,5,0,5,0,0,0,0
50,105-CHANDIGARH,050027-St. Theresa's Convent School,2,5,0,5,0,0,0,0
51,111-ALLAHABAD/PRAYAGRAJ,210414-Jawahar Navodaya Vidyalaya,1,6,0,6,0,0,0,0
52,111-ALLAHABAD/PRAYAGRAJ,210620-Premchandra Shivdhara Inter College,1,6,0,6,0,0,0,0
53,102-PUNE,110149-Army Public School,1,6,0,6,0,0,0,0
54,115-BHUBANESWAR,150032-Oriental Public School,2,6,4,2,2,2,66.67,33.33
55,103-KOLKATA,220110-Kendriya Vidyalaya,1,6,0,6,0,0,0,0
56,125-JAMMU,070038-Jawahar Navodaya Vidyalaya,2,6,0,6,0,0,0,0
57,114-DEHRADUN,M38371-Madrasa Mahaboobiya High School,1,6,0,6,0,0,0,0
58,109-JAIPUR,170366-Navodaya Bal Senior Sec. School,1,6,0,6,0,0,0,0
59,111-ALLAHABAD/PRAYAGRAJ,M21544-Al Jamiatul Islamia Khairul Uloom,1,6,6,0,6,0,100,100
60,123-GANGTOK,180008-Govt. Senior Secondary School,1,6,6,0,2,4,100,33.33
61,110-PATNA,030011-Jawahar Navodaya Vidyalaya,1,6,0,6,0,0,0,0
62,120-RANCHI,260094-+2 High School,1,6,0,6,0,0,0,0
63,104-GUWAHATI,320108-58 GTC,1,6,0,6,0,0,0,0
64,113-BHOPAL,100266-Baba Ram Piyare Memorial Higher,1,6,0,6,0,0,0,0
65,101-HYDERABAD,M01199-St. Andrews High School,1,6,0,6,0,0,0,0
66,122-DHARAMSALA,060012-Govt. Sr. Sec. School,1,6,0,6,0,0,0,0
67,120-RANCHI,260054-D.a.v. Public School Barkakana,2,6,0,6,0,0,0,0
68,105-CHANDIGARH,050659-Vidyantriksh Sr. Sec. School,1,6,0,6,0,0,0,0
69,120-RANCHI,260111-+2 High School,2,6,0,6,0,0,0,0
70,111-ALLAHABAD/PRAYAGRAJ,210435-Jawahar Navodaya Vidyalaya,1,6,0,6,0,0,0,0
71,105-CHANDIGARH,M16110-Nightingle Sr.Sec. School,1,6,0,6,0,0,0,0
72,110-PATNA,"030253-High School,",1,5,0,5,0,0,0,0
73,107-DELHI,210722-Ganga Inter National College,1,6,0,6,0,0,0,0
74,106-KOCHI,M09102-Bappuji English Medium School,2,6,0,6,0,0,0,0
75,114-DEHRADUN,340223-Govt. Inter College,2,6,0,6,0,0,0,0
76,107-DELHI,050337-Genius Convent Sr. Sec. School,1,6,0,6,0,0,0,0
77,122-DHARAMSALA,060033-Govt. Senior Secondary School,2,6,0,6,0,0,0,0
78,121-CHENNAI,190079-Govt. Hr. Sec. School,1,5,0,5,0,0,0,0
79,107-DELHI,210394-Gautam Public Hr.sec.school,1,6,0,6,0,0,0,0
80,114-DEHRADUN,340112-Govt. Inter College,1,6,0,6,0,0,0,0
81,121-CHENNAI,320412-The Madras Regimental Centre,2,6,0,6,0,0,0,0
82,111-ALLAHABAD/PRAYAGRAJ,M21493-Madarsa Muskan,1,6,0,6,0,0,0,0
83,111-ALLAHABAD/PRAYAGRAJ,210330-Kanpur Public School,1,6,0,6,0,0,0,0
84,114-DEHRADUN,M38237-Jamia Farooquia Azizul Uloom,1,6,0,6,0,0,0,0
85,111-ALLAHABAD/PRAYAGRAJ,210760-Pt. Gupt Ram Pandey Adarsh Inter College,2,6,0,6,0,0,0,0
86,102-PUNE,110131-Kendriya Vidyalaya,1,6,0,6,0,0,0,0
87,111-ALLAHABAD/PRAYAGRAJ,M38184-Amiraddaula Islamia Inter College,1,6,0,6,0,0,0,0
88,103-KOLKATA,189001-Regional Centre-Gangtok,1,6,6,0,0,6,100,0
89,121-CHENNAI,190018-Veera Savarkar Netaji Matric.school,2,6,5,1,5,0,83.33,83.33
90,105-CHANDIGARH,160092-Doon Valley Cambridge School,1,6,0,6,0,0,0,0
91,109-JAIPUR,170331-Sankalp Academy Sr.sec. School,1,6,0,6,0,0,0,0
92,114-DEHRADUN,340263-Adarsh Hr. Sec. School,1,6,0,6,0,0,0,0
93,115-BHUBANESWAR,410006-Govt. Higher Secondary School,1,6,3,3,2,1,50,33.33
94,107-DELHI,M27476-Shiv Modern Senior Secondary School,1,6,0,6,0,0,0,0
95,105-CHANDIGARH,050453-Sarvodaya Sr.sec. School,1,6,0,6,0,0,0,0
96,113-BHOPAL,"100093-Mata Beti Bai Public School,",2,6,0,6,0,0,0,0
97,121-CHENNAI,310011-Navalar Nedunchezhian Govt.Hr.Sec.School,1,6,0,6,0,0,0,0
98,120-RANCHI,260085-Jawahar Navodaya Vidyalaya,1,6,0,6,0,0,0,0
99,116-VISAKHAPATNAM,470221-Silver Oaks High School,2,6,5,1,0,5,83.33,0
100,105-CHANDIGARH,050609-Aravali Modern School,1,6,0,6,0,0,0,0
1,105-CHANDIGARH,050609-Aravali Modern School,1,6,0,6,0,0,0,0
2,107-DELHI,050411-Universal Senior Secondary School,2,6,0,6,0,0,0,0
3,104-GUWAHATI,140028-Govt. Higher Secondary School,1,6,4,2,1,3,66.67,16.67
4,120-RANCHI,260102-Smt. Anarkali +2 School,1,6,0,6,0,0,0,0
5,120-RANCHI,260172-K.b.s.s.+2 High School,1,6,0,6,0,0,0,0
6,105-CHANDIGARH,050140-Happy Sr. Sec. School,1,6,0,6,0,0,0,0
7,120-RANCHI,260137-Sant Tulsidas +2 High School,1,6,0,6,0,0,0,0
8,104-GUWAHATI,020052-Jawahar Navodaya Vidyalaya,1,6,5,1,0,5,83.33,0
9,105-CHANDIGARH,050237-Vivekanand Sr. Sec. School,1,6,0,6,0,0,0,0
10,105-CHANDIGARH,160134-Guru Nanak Public School,1,6,0,6,0,0,0,0
11,107-DELHI,"G27048-Govt Sarvodaya Kanya Vidalaya, H Block , Phase -1 Ashok Vihar, North West B Delhi-110052",2,6,0,6,0,0,0,0
12,120-RANCHI,260195-Name 5141,1,6,0,6,0,0,0,0
13,105-CHANDIGARH,050051-Shiv Shakti Sr. Sec. School,1,6,0,6,0,0,0,0
14,103-KOLKATA,230006-Govt. Girls Sr. Sec School,1,6,0,6,0,0,0,0
15,109-JAIPUR,170182-Prince International School,1,6,0,6,0,0,0,0
16,104-GUWAHATI,020019-Little Flower School,2,6,2,4,0,2,33.33,0
17,121-CHENNAI,310006-Annai Teresa Govt. Girls Hr. Sec.,1,6,0,6,0,0,0,0
18,111-ALLAHABAD/PRAYAGRAJ,M21652-Sir Syed Public School,1,6,0,6,0,0,0,0
19,120-RANCHI,260135-+2 High School,2,6,0,6,0,0,0,0
20,109-JAIPUR,170300-Bhoomija Sr.sec. School,1,6,0,6,0,0,0,0
21,115-BHUBANESWAR,150187-Brajendra High School,1,6,3,3,3,0,50,50
22,116-VISAKHAPATNAM,010150-Sri Pragyna Junior College,1,6,6,0,0,6,100,0
23,103-KOLKATA,M22073-St. Thomas High School,2,6,0,6,0,0,0,0
24,114-DEHRADUN,340123-Govt. Inter College,2,6,0,6,0,0,0,0
25,114-DEHRADUN,340231-Govt. Intermediate College,1,6,0,6,0,0,0,0
26,104-GUWAHATI,440003-Orang Higher Secondary School,1,6,3,3,3,0,50,50
27,109-JAIPUR,170355-Hukumchand Public School,1,6,0,6,0,0,0,0
28,104-GUWAHATI,240030-Govt. Higher Secondary School,1,6,0,6,0,0,0,0
29,114-DEHRADUN,340318-Doon Bhawani International School,1,6,0,6,0,0,0,0
30,106-KOCHI,M09062-Mit Trust English Medium School,1,6,0,6,0,0,0,0
31,111-ALLAHABAD/PRAYAGRAJ,210013-St. Queen Mary's Public School,2,6,0,6,0,0,0,0
32,103-KOLKATA,220015-Marwari Panchayat Charity Trust,1,6,6,0,6,0,100,100
33,109-JAIPUR,170049-Mahaveer Vidya Mandir,1,6,0,6,0,0,0,0
34,111-ALLAHABAD/PRAYAGRAJ,210639-Sh. Ramesh Chandra I.c. Sonai,1,6,0,6,0,0,0,0
35,114-DEHRADUN,340102-Maharishi Vidya Mandir,2,6,0,6,0,0,0,0
36,102-PUNE,110120-Jawahar Navodaya Vidyalaya,1,6,0,6,0,0,0,0
37,109-JAIPUR,170148-Adarsh Gyan Mandir Sr.sec. School,2,6,0,6,0,0,0,0
38,111-ALLAHABAD/PRAYAGRAJ,210739-Guruteg Bahadur Educational Academy,1,6,0,6,0,0,0,0
39,117-BENGALURU,080072-BVM GLOBAL SCHOOL BENGALURU,1,6,5,1,0,5,83.33,0
40,116-VISAKHAPATNAM,010144-Sri Harsha's Junior  & Degree,1,5,5,0,0,5,100,0
41,107-DELHI,270349-Govt.sarvodaya Co-ed. Sr.sec.school,1,5,0,5,0,0,0,0
42,120-RANCHI,260116-Sarvodaya +2 High School,1,5,0,5,0,0,0,0
43,104-GUWAHATI,020030-Kendriya Vidyalaya,1,5,1,4,0,1,20,0
44,104-GUWAHATI,020079-L.N. Bezbarua High School,1,5,0,5,0,0,0,0
45,104-GUWAHATI,140018-Neingulie Memorial High School,1,5,1,4,0,1,20,0
46,121-CHENNAI,190087-Kendriya Vidyalaya,1,5,0,5,0,0,0,0
47,109-JAIPUR,170110-Kamalnishtha Vidya Niketan,1,5,0,5,0,0,0,0
48,111-ALLAHABAD/PRAYAGRAJ,210633-Sardar Raj Narayan Yadav Inter,1,5,0,5,0,0,0,0
49,120-RANCHI,260096-Zila School,1,5,0,5,0,0,0,0
50,125-JAMMU,070017-Girls Higher Sec. School,2,5,0,5,0,0,0,0
51,104-GUWAHATI,440001-Diphu Commerce Junior College,1,5,2,3,2,0,40,40
52,105-CHANDIGARH,050625-St. Simran Public School,1,5,0,5,0,0,0,0
53,113-BHOPAL,"100077-Scope Public School,",1,5,0,5,0,0,0,0
54,105-CHANDIGARH,050598-Rajwanshi Shiksha Niketan Sr. Sec. School,1,5,0,5,0,0,0,0
55,118-GANDHINAGAR,390160-Sandipani Gurukul Vidhyalay,1,5,5,0,5,0,100,100
56,109-JAIPUR,170325-Sh. Narayan Sr.sec. School,1,5,0,5,0,0,0,0
57,122-DHARAMSALA,060042-B.l. Central Public School,1,5,0,5,0,0,0,0
58,111-ALLAHABAD/PRAYAGRAJ,210468-Pt. Ram Sahay Sharma Inter College,1,5,0,5,0,0,0,0
59,103-KOLKATA,230002-Govt. Senior Secondary School,1,5,0,5,0,0,0,0
60,114-DEHRADUN,340226-Govt. Inter College,2,5,0,5,0,0,0,0
61,110-PATNA,030418-P.K.JHA UCHCHATER MADHYMIK VIDHYALAYA ,1,5,0,5,0,0,0,0
62,102-PUNE,M38333-Salahuddin Ayyubi Memorial Urdu,1,5,0,5,0,0,0,0
63,105-CHANDIGARH,050560-Deewal Interrnational School,1,5,0,5,0,0,0,0
64,103-KOLKATA,220064-B.d.memorial English High School,1,5,0,5,0,0,0,0
65,105-CHANDIGARH,050119-Swami Vivekanand Modern School,1,5,0,5,0,0,0,0
66,105-CHANDIGARH,160075-Jawahar Navodaya Vidyalaya,1,5,0,5,0,0,0,0
67,105-CHANDIGARH,160146-N.R.M. HOLLY HEART CONVENT SCHOOL,1,5,0,5,0,0,0,0
68,105-CHANDIGARH,050514-Satluj Senior Secondary School,1,5,5,0,3,2,100,60
69,106-KOCHI,M09086-Aes Public School,1,5,0,5,0,0,0,0
70,121-CHENNAI,420090-The Trinity Academy,1,5,0,5,0,0,0,0
71,114-DEHRADUN,320315-The Kumaon Regt Centre,1,5,0,5,0,0,0,0
72,107-DELHI,M38370-Jesus Grace Modern School,1,5,0,5,0,0,0,0
73,121-CHENNAI,M19106-PERAL MATRICULATION SCHOOL,1,5,0,5,0,0,0,0
74,109-JAIPUR,170336-Parmarth Khetaramji Sr.sec. Scchool,1,5,0,5,0,0,0,0
75,111-ALLAHABAD/PRAYAGRAJ,210807-Rama Convent Inter College,1,5,0,5,0,0,0,0
76,115-BHUBANESWAR,410102-Govt. High School,1,5,2,3,1,1,40,20
77,105-CHANDIGARH,050430-Global Public School,1,5,0,5,0,0,0,0
78,102-PUNE,M38267-Fazlani L'academie Globale,1,5,2,3,2,0,40,40
79,107-DELHI,270552-St. Francis Convent School,1,5,0,5,0,0,0,0
80,120-RANCHI,260129-+2 High School,1,5,0,5,0,0,0,0
81,117-BENGALURU,080069-Patel Public School,1,5,0,5,0,0,0,0
82,107-DELHI,J05286-District  Jail,1,5,0,5,0,0,0,0
83,114-DEHRADUN,340314-DR. B.R.A INTER COLLEGE,1,5,0,5,0,0,0,0
84,121-CHENNAI,190037-Kendriya Vidydalaya,1,5,0,5,0,0,0,0
85,118-GANDHINAGAR,040080-Shree Krishna Secondary Higher Secondary School,1,5,5,0,5,0,100,100
86,123-GANGTOK,180019-Govt. Senior Secondary School,0,0,0,0,0,0,0,0
87,111-ALLAHABAD/PRAYAGRAJ,210681-Pd. Raj Nayan Intermediate College,1,5,0,5,0,0,0,0
88,105-CHANDIGARH,050471-S.d.senior Secondary School,1,5,5,0,5,0,100,100
89,125-JAMMU,070036-Jawahar Navodaya Vidyalaya,1,5,0,5,0,0,0,0
90,110-PATNA,M03378-Khalikum Nisha Sajjad Millat,1,5,0,5,0,0,0,0
91,109-JAIPUR,170279-Stanford Global Academy,1,5,0,5,0,0,0,0
92,110-PATNA,030409-Chandrasheel Vidyapeeth,1,5,0,5,0,0,0,0
93,121-CHENNAI,190166-Shree Raaja Rajan School,1,5,5,0,0,5,100,0
94,114-DEHRADUN,340063-Govt. Intermediate College,1,4,0,4,0,0,0,0
95,113-BHOPAL,"100074-Vivekanand Public Hr.sec. School,",1,5,0,5,0,0,0,0
96,110-PATNA,030197-Rajkiyakrit Ucchvidyalaya,1,5,0,5,0,0,0,0
97,105-CHANDIGARH,050276-Bal Bharti Adarsh Vidhyalaya,1,5,0,5,0,0,0,0
98,118-GANDHINAGAR,040097-Brahmani Vidhyalay,1,5,5,0,4,1,100,80
99,110-PATNA,030367-Jawahar Navodaya Vidyalaya,1,5,0,5,0,0,0,0
100,102-PUNE,M11130-Iqra English Medium school,1,5,0,5,0,0,0,0
1,105-CHANDIGARH,050509-Hindu Senior Secondary School,1,5,0,5,0,0,0,0
2,107-DELHI,270424-Pragati Public School,1,5,0,5,0,0,0,0
3,105-CHANDIGARH,J16004-Name 4921,2,5,0,5,0,0,0,0
4,105-CHANDIGARH,T16009-SHAHEED BHAGAT SINGH PVT. ITI,3,5,5,0,5,0,100,100
5,111-ALLAHABAD/PRAYAGRAJ,210529-Indresh Verma Vidyapeeth Balika,1,5,0,5,0,0,0,0
6,111-ALLAHABAD/PRAYAGRAJ,210796-Narayan College of Science and Arts,1,5,0,5,0,0,0,0
7,105-CHANDIGARH,050001-Janta Kalyan Samiti,1,5,0,5,0,0,0,0
8,103-KOLKATA,220131-Holy Christ Secondary School,1,5,0,5,0,0,0,0
9,102-PUNE,110132-Sudershan English High School &,1,5,0,5,0,0,0,0
10,105-CHANDIGARH,160166-Holy Angels Smart School,1,5,0,5,0,0,0,0
11,110-PATNA,030008-Jawahar Navodaya Vidyalaya,1,5,0,5,0,0,0,0
12,122-DHARAMSALA,060010-Govt. Sr. Sec. School,1,5,0,5,0,0,0,0
13,118-GANDHINAGAR,040096-Swami Vivekanand Vidhyalaya,1,5,5,0,5,0,100,100
14,107-DELHI,050642-B S M High School,1,5,0,5,0,0,0,0
15,110-PATNA,030366-Dr. Shaligram Mishra College,1,5,0,5,0,0,0,0
16,121-CHENNAI,420079-Helikx Special Learning School,1,5,0,5,0,0,0,0
17,104-GUWAHATI,140031-Govt. High School,1,5,1,4,0,1,20,0
18,107-DELHI,050322-Vidya Niketan Sr.sec. School,1,5,0,5,0,0,0,0
19,113-BHOPAL,100311-Noble Public School,1,5,5,0,0,5,100,0
20,109-JAIPUR,170197-Govt. Senior Secondary School,1,5,0,5,0,0,0,0
21,125-JAMMU,070033-Jawahar Navodaya Vidyalaya,1,5,0,5,0,0,0,0
22,107-DELHI,G27007-Sarvodaya Vidyalaya Badarpur Kahadar Delhi-110090,1,5,0,5,0,0,0,0
23,104-GUWAHATI,"020025-Kendriya Vidyalaya Afs,",1,5,2,3,0,2,40,0
24,110-PATNA,M03358-Madarsa Ahmdia Hanfia,1,5,0,5,0,0,0,0
25,120-RANCHI,260174-Govt. Govind +2 School,1,5,0,5,0,0,0,0
26,117-BENGALURU,M08020-Excellent English School,1,5,0,5,0,0,0,0
27,113-BHOPAL,100098-Ekta High School,1,5,0,5,0,0,0,0
28,103-KOLKATA,220130-Gocharan North Point Institute,1,5,0,5,0,0,0,0
29,107-DELHI,270523-CIAT Convent School,1,5,0,5,0,0,0,0
30,111-ALLAHABAD/PRAYAGRAJ,210594-Maa Tripur Sundari Public School,1,5,0,5,0,0,0,0
31,115-BHUBANESWAR,150139-Govt. (ssd) Girls High School,1,5,2,3,1,1,40,20
32,106-KOCHI,400048-Kendriya Vidyalaya,1,5,0,5,0,0,0,0
33,110-PATNA,030399-New Horizon School,1,5,2,3,0,2,40,0
34,105-CHANDIGARH,160163-Adarsh Modern High School,1,5,0,5,0,0,0,0
35,120-RANCHI,260141-R.n.r. +2 High School,1,5,0,5,0,0,0,0
36,121-CHENNAI,190060-Govt. Hr. Sec. School,1,5,0,5,0,0,0,0
37,111-ALLAHABAD/PRAYAGRAJ,210717-Radhika Senior Secondary School,1,5,0,5,0,0,0,0
38,102-PUNE,M11128-Al Ameen English High School,1,5,0,5,0,0,0,0
39,113-BHOPAL,100166-Ram Sundar Higher Secondary School,1,5,0,5,0,0,0,0
40,111-ALLAHABAD/PRAYAGRAJ,210793-Pahalwan Gurudeen Public School,1,5,0,5,0,0,0,0
41,106-KOCHI,M09037-Mar Ivonios Bethany School,1,5,0,5,0,0,0,0
42,110-PATNA,M03233-Millat Academy Station Road,1,5,0,5,0,0,0,0
43,107-DELHI,210762-HINDON PUBLIC SCHOOL,2,5,0,5,0,0,0,0
44,111-ALLAHABAD/PRAYAGRAJ,M38179-Saint Kabir Inter College,1,5,5,0,5,0,100,100
45,110-PATNA,030062-Adarsh High School,1,5,0,5,0,0,0,0
46,111-ALLAHABAD/PRAYAGRAJ,210431-Jawahar Navodaya Vidyalaya,1,5,0,5,0,0,0,0
47,111-ALLAHABAD/PRAYAGRAJ,210582-Raj Devi Ram Karan Public School,1,5,0,5,0,0,0,0
48,103-KOLKATA,450180-Voice of World,3,5,5,0,5,0,100,100
49,105-CHANDIGARH,160091-R.k.public High School,1,5,0,5,0,0,0,0
50,105-CHANDIGARH,050422-Shivaniaa Public School,1,5,0,5,0,0,0,0
51,111-ALLAHABAD/PRAYAGRAJ,210751-Green Field Aademy,1,5,0,5,0,0,0,0
52,104-GUWAHATI,020055-Jawahar Navodaya Vidyalaya,1,5,1,4,0,1,20,0
53,105-CHANDIGARH,M16009-Guru Nanak Sr. Sec. School,1,5,0,5,0,0,0,0
54,120-RANCHI,M26187-Shine Valley School,1,5,0,5,0,0,0,0
55,118-GANDHINAGAR,M04023-Peer Haji Alisha Bukhari High,1,5,5,0,5,0,100,100
56,113-BHOPAL,"100060-Vidya Bharti Higher Sec School,",1,5,0,5,0,0,0,0
57,107-DELHI,050084-D.s. Arya High School,1,5,3,2,3,0,60,60
58,121-CHENNAI,190059-Govt. Hr. Sec. School,1,5,0,5,0,0,0,0
59,102-PUNE,110101-Cges Gulabtola High School&junior,1,4,0,4,0,0,0,0
60,105-CHANDIGARH,160014-Vivekanand Blessed Sr.sec. School,1,5,0,5,0,0,0,0
61,119-RAIPUR,290168-Dr. Padumal Punnalal Buxi Model,1,5,0,5,0,0,0,0
62,104-GUWAHATI,020035-Kendriya Vidyalaya,2,5,1,4,0,1,20,0
63,109-JAIPUR,M17269-Raza Public Sr.sec. School,1,5,0,5,0,0,0,0
64,107-DELHI,270028-Yuva Shakti Model School,1,5,0,5,0,0,0,0
65,110-PATNA,030075-M.g.smarak Ucch Vidyalaya,1,5,0,5,0,0,0,0
66,119-RAIPUR,290084-Jawahar Navodaya Vidyalaya,1,5,0,5,0,0,0,0
67,113-BHOPAL,100142-Jawahar Navodaya Vidyalaya,1,5,0,5,0,0,0,0
68,105-CHANDIGARH,050330-Baba Balak Nath Sr.sec. School,1,5,4,1,0,4,80,0
69,107-DELHI,210345-Chodhary Charan Singh Memorial Sr,1,5,0,5,0,0,0,0
70,111-ALLAHABAD/PRAYAGRAJ,M21660-AL HAFEEZ EDUCATIONAL ACADEMY,1,5,0,5,0,0,0,0
71,113-BHOPAL,100092-Baba Nepali Higher Secondary School,1,5,0,5,0,0,0,0
72,121-CHENNAI,190074-Govt. Hr. Sec. School,1,5,0,5,0,0,0,0
73,118-GANDHINAGAR,040132-Sandipani Gurukul Vidhyalay,1,5,5,0,3,2,100,60
74,105-CHANDIGARH,050521-Model Sanskriti Sr.Sec. School,1,5,0,5,0,0,0,0
75,125-JAMMU,"320525-Hrdc, Hq",1,5,0,5,0,0,0,0
76,121-CHENNAI,420104-BVM GLOBAL BOLLINENI HILLSIDE SENIOR SECONDARY SCHOOL,1,5,0,5,0,0,0,0
77,114-DEHRADUN,340322-New Oxford Higher Secondary School,1,5,0,5,0,0,0,0
78,107-DELHI,270117-Shaheed Hemu Kalani Govt. Sarvodaya,1,5,0,5,0,0,0,0
79,119-RAIPUR,290165-Saraswati Vihar English Medium,1,5,0,5,0,0,0,0
80,113-BHOPAL,100198-Jawahar Navodaya Vidyalaya,1,5,0,5,0,0,0,0
81,107-DELHI,050622-Universal Public School,1,5,0,5,0,0,0,0
82,110-PATNA,"030344-+2 High School,",1,5,0,5,0,0,0,0
83,107-DELHI,270418-Mother Khazani Convent School,1,5,0,5,0,0,0,0
84,114-DEHRADUN,210784-Divine Global Academy,1,5,0,5,0,0,0,0
85,117-BENGALURU,M08056-St. Francis School,1,5,0,5,0,0,0,0
86,105-CHANDIGARH,050652-Janta Shiksha Sadan,1,5,0,5,0,0,0,0
87,113-BHOPAL,100137-Jawahar Navodaya Vidyalaya,1,5,0,5,0,0,0,0
88,104-GUWAHATI,140026-Govt. High School,1,5,1,4,0,1,20,0
89,121-CHENNAI,190097-Suddananda Vidyalaya,1,5,0,5,0,0,0,0
90,107-DELHI,270276-Convent Of Gagan Bhatri Sr.s.school,1,5,0,5,0,0,0,0
91,104-GUWAHATI,200035-Name 4401,1,5,2,3,2,0,40,40
92,105-CHANDIGARH,050138-Shastri High School,1,5,0,5,0,0,0,0
93,113-BHOPAL,100086-Vishwa Bharti Higher Sec. School,1,5,0,5,0,0,0,0
94,102-PUNE,110122-Jawahar Navodaya Vidyalaya,1,5,0,5,0,0,0,0
95,119-RAIPUR,T29001-Jagrani Devi ITI,1,5,0,5,0,0,0,0
96,116-VISAKHAPATNAM,370089-Vignan Talent School,1,5,5,0,0,5,100,0
97,114-DEHRADUN,340274-Baluni Public School,1,5,0,5,0,0,0,0
98,101-HYDERABAD,470187-Kendriya Vidyalaya,1,5,0,5,0,0,0,0
99,117-BENGALURU,"V08004-Shubham Karoti, Maitreyee Gurukula",1,5,0,5,0,0,0,0
100,110-PATNA,030260-J.n.k.t.inter School,1,5,0,5,0,0,0,0
1,105-CHANDIGARH,050494-Sh. Lal Bahadur Shastri High School,1,5,0,5,0,0,0,0
2,121-CHENNAI,420059-Kendriya Vidyalaya,1,5,0,5,0,0,0,0
3,120-RANCHI,260194-MOTHER'S INTERNATIONAL ACADEMY,1,5,0,5,0,0,0,0
4,104-GUWAHATI,020033-Kendriya Vidyalya,1,5,1,4,0,1,20,0
5,105-CHANDIGARH,160063-A Pee Ji Public Sr.sec.school,1,5,0,5,0,0,0,0
6,111-ALLAHABAD/PRAYAGRAJ,210421-Vansha Devi Inter College,1,5,0,5,0,0,0,0
7,102-PUNE,110121-Jawahar Navodaya Vidyalaya,1,5,0,5,0,0,0,0
8,111-ALLAHABAD/PRAYAGRAJ,210788-Paras Public School,1,5,0,5,0,0,0,0
9,115-BHUBANESWAR,150049-Govt. Girls High School,1,5,2,3,1,1,40,20
10,116-VISAKHAPATNAM,010209-HEAL SCHOOL,1,5,5,0,0,5,100,0
11,113-BHOPAL,M10275-Madarsa Talimul Quran,1,5,0,5,0,0,0,0
12,103-KOLKATA,220101-Kendriya Vidyalaya,1,5,4,1,4,0,80,80
13,114-DEHRADUN,340196-Govt. Inter College,1,5,0,5,0,0,0,0
14,111-ALLAHABAD/PRAYAGRAJ,210708-GAURI SHANKAR PUBLIC SCHOOL,2,5,0,5,0,0,0,0
15,102-PUNE,M11089-N.t.c.c High School,1,5,0,5,0,0,0,0
16,105-CHANDIGARH,050489-Pushpa Kanya Sr. Secondary School,1,5,0,5,0,0,0,0
17,120-RANCHI,260193-Saraswati Shishu Vidya Mandir,1,5,0,5,0,0,0,0
18,109-JAIPUR,170327-Manju Public Sr. Secondary School,1,5,0,5,0,0,0,0
19,107-DELHI,210746-Sidhi Vinayak Public School,1,5,0,5,0,0,0,0
20,110-PATNA,450093-J.m.institute Of Speech & Hearing,1,5,0,5,0,0,0,0
21,108-ABROAD/NIOS HQ,980003-Indian School,1,4,0,4,0,0,0,0
22,114-DEHRADUN,210675-Dron Public School,1,5,0,5,0,0,0,0
23,111-ALLAHABAD/PRAYAGRAJ,210147-Saint Vivekanandsr.sec.publicschool,1,5,0,5,0,0,0,0
24,119-RAIPUR,290140-Govt. Boys Higher Secondary School,1,5,0,5,0,0,0,0
25,102-PUNE,110075-Shri Bhavani Vidyamandir,1,5,0,5,0,0,0,0
26,110-PATNA,030374-JAWAHAR NAVODAYA VIDYALAYA,1,5,0,5,0,0,0,0
27,109-JAIPUR,M38315-Khawaja Model School,1,5,0,5,0,0,0,0
28,111-ALLAHABAD/PRAYAGRAJ,M21370-Roshan Higher Secondary School,1,5,0,5,0,0,0,0
29,110-PATNA,030093-Satyendra Narayan Mahila Maha-,1,5,0,5,0,0,0,0
30,118-GANDHINAGAR,040042-Kendriya Vidyalaya,1,4,4,0,1,3,100,25
31,118-GANDHINAGAR,040084-Govt. Khetivadi Sec. & High sec. School,1,4,4,0,1,3,100,25
32,122-DHARAMSALA,060045-St.soldier Convent Sr.sec. School,1,4,0,4,0,0,0,0
33,119-RAIPUR,290174-Vindhya Public School,1,4,0,4,0,0,0,0
34,120-RANCHI,260164-Govt. +2 High School,1,4,0,4,0,0,0,0
35,113-BHOPAL,100188-Shanti Niketan Higher Secondary,1,4,0,4,0,0,0,0
36,107-DELHI,T27001-Baba Saheb Ambedkar Industrial Training Centre,2,4,0,4,0,0,0,0
37,121-CHENNAI,420091-Kmc Public Senior Secondary School,1,4,0,4,0,0,0,0
38,117-BENGALURU,M48002-Delhi Public School,2,4,0,4,0,0,0,0
39,109-JAIPUR,170369-Noble International School,1,4,0,4,0,0,0,0
40,107-DELHI,270294-Tagore School,1,4,0,4,0,0,0,0
41,105-CHANDIGARH,380276-Kalyan Sr.sec. School,1,4,0,4,0,0,0,0
42,120-RANCHI,260113-+2 Hari High School,1,4,0,4,0,0,0,0
43,121-CHENNAI,420048-Nanjappa Municipal Boys Hr. Sec.,0,0,0,0,0,0,0,0
44,105-CHANDIGARH,160050-Star Plus Convent School,1,4,0,4,0,0,0,0
45,120-RANCHI,260154-R.k.+2 High School,1,4,0,4,0,0,0,0
46,117-BENGALURU,480001-Don Bosco Academy,1,4,0,4,0,0,0,0
47,110-PATNA,030207-L M Ucch Vidyalaya,0,0,0,0,0,0,0,0
48,119-RAIPUR,290106-Govt. Girls Hr.sec. School,1,4,0,4,0,0,0,0
49,109-JAIPUR,170146-Suraj Public School,1,4,0,4,0,0,0,0
50,105-CHANDIGARH,050539-Shaheed Udham Singh Sr. Sec. School,1,4,0,4,0,0,0,0
51,121-CHENNAI,190153-Sagar International School,1,4,0,4,0,0,0,0
52,118-GANDHINAGAR,390099-Jivan Vikas Education Academy,1,4,4,0,4,0,100,100
53,101-HYDERABAD,470057-Govt. Girls School,1,4,0,4,0,0,0,0
54,113-BHOPAL,100121-Kendriya Vidyalaya,1,4,0,4,0,0,0,0
55,105-CHANDIGARH,050152-Sarvodaya Shiksha Sadan,1,4,0,4,0,0,0,0
56,116-VISAKHAPATNAM,010067-S S Jr.college & Sidhartha H.school,1,4,4,0,0,4,100,0
57,121-CHENNAI,420007-Mahatma Montessori School,3,4,0,4,0,0,0,0
58,117-BENGALURU,M08036-Al Nisa Women's Pre University,1,4,0,4,0,0,0,0
59,105-CHANDIGARH,050293-B.r.m.sr.sec. School,1,4,0,4,0,0,0,0
60,122-DHARAMSALA,060093-Ajay Model Sr.sec. School,1,4,0,4,0,0,0,0
61,113-BHOPAL,100037-Navambey Convent Hr.sec. School,1,4,0,4,0,0,0,0
62,115-BHUBANESWAR,T41001-Name 5131,2,4,2,2,2,0,50,50
63,114-DEHRADUN,210742-H.C.M. Inter College,1,4,0,4,0,0,0,0
64,105-CHANDIGARH,050010-D C Model High School,1,4,0,4,0,0,0,0
65,105-CHANDIGARH,160095-Sidhu Memorial Public School,1,4,0,4,0,0,0,0
66,105-CHANDIGARH,160168-Meera Medical Institute of Nursing & Hospital,1,4,0,4,0,0,0,0
67,105-CHANDIGARH,050555-Om Prakash Garg Memorial Public Sch,1,4,0,4,0,0,0,0
68,111-ALLAHABAD/PRAYAGRAJ,210765-Raksha Devi Inter College,1,4,0,4,0,0,0,0
69,122-DHARAMSALA,060011-Govt. Sr.sec. School,1,4,0,4,0,0,0,0
70,104-GUWAHATI,"240022-Kendriya Vidyalaya,",1,4,0,4,0,0,0,0
71,105-CHANDIGARH,050590-Saraswati Vidya Mandir Sr. Sec. School,1,4,0,4,0,0,0,0
72,105-CHANDIGARH,050658-Disha International School,1,4,0,4,0,0,0,0
73,105-CHANDIGARH,050468-Pratap Singh Memorial Sr.sec.school,1,4,0,4,0,0,0,0
74,105-CHANDIGARH,050114-Ved Model High School,0,0,0,0,0,0,0,0
75,105-CHANDIGARH,050554-Mother Teresa Modern Public School,1,4,0,4,0,0,0,0
76,109-JAIPUR,170252-Jawahar Navodaya Vidyalaya,1,4,0,4,0,0,0,0
77,102-PUNE,M38180-Sir Sayyad English High School,1,4,0,4,0,0,0,0
78,118-GANDHINAGAR,M04034-St.mary's School,1,4,4,0,3,1,100,75
79,105-CHANDIGARH,160070-Modern Public High School,1,4,0,4,0,0,0,0
80,105-CHANDIGARH,T16006-P.S. Technical Institute of,2,4,0,4,0,0,0,0
81,121-CHENNAI,190077-Govt. Hr. Sec. School,1,4,0,4,0,0,0,0
82,118-GANDHINAGAR,V04001-Hemachandrachary Sanskrit Pathshala,1,4,4,0,1,3,100,25
83,105-CHANDIGARH,050110-Nehru Senior Secondary School,1,4,0,4,0,0,0,0
84,114-DEHRADUN,340279-Govt. Inter College,1,4,0,4,0,0,0,0
85,121-CHENNAI,T19001-Advanced Training Institute,2,4,0,4,0,0,0,0
86,109-JAIPUR,170224-Jawahar Navodaya Vidyalaya,1,4,0,4,0,0,0,0
87,110-PATNA,"030356-St.paul Secondary School,",2,4,0,4,0,0,0,0
88,107-DELHI,270042-Bal Mandir Public School,1,4,0,4,0,0,0,0
89,115-BHUBANESWAR,150176-Police High School,1,4,3,1,2,1,75,50
90,117-BENGALURU,"M08019-St.paul's High School,",1,4,0,4,0,0,0,0
91,121-CHENNAI,"420106-The Pupil Saveetha Eco. School,",1,4,0,4,0,0,0,0
92,109-JAIPUR,170220-Adarsh Naveen Sr. Secondary School,1,4,0,4,0,0,0,0
93,116-VISAKHAPATNAM,010166-Kendriya Vidyalaya,1,4,4,0,0,4,100,0
94,121-CHENNAI,M19040-Green Valley Matriculation &,1,4,0,4,0,0,0,0
95,114-DEHRADUN,M38345-Maa Wahida Begum High School,1,4,0,4,0,0,0,0
96,117-BENGALURU,080029-Kandriya Vidyalaya,1,4,0,4,0,0,0,0
97,107-DELHI,270456-St. Matthew's Public School,1,4,0,4,0,0,0,0
98,107-DELHI,050164-Gyandeep Sr.sec School,1,4,0,4,0,0,0,0
99,121-CHENNAI,190053-Govt. High School,1,4,0,4,0,0,0,0
100,118-GANDHINAGAR,040061-Laxmi International School,1,4,4,0,4,0,100,100
1,105-CHANDIGARH,050550-Navyug Sr.Sec. School,1,4,0,4,0,0,0,0
2,121-CHENNAI,190053-Govt. High School,1,4,0,4,0,0,0,0
3,118-GANDHINAGAR,040061-Laxmi International School,1,4,4,0,4,0,100,100
4,102-PUNE,110042-Holly Cross Boys High School,1,4,4,0,4,0,100,100
5,113-BHOPAL,100083-Care English Hr.sec.school,1,4,0,4,0,0,0,0
6,114-DEHRADUN,M34257-Madarsa Ishatul Haq,1,4,0,4,0,0,0,0
7,102-PUNE,M36110-Fr. Agnel Multipurpose School,1,4,0,4,0,0,0,0
8,115-BHUBANESWAR,150186-Chirstian High School,1,4,1,3,0,1,25,0
9,113-BHOPAL,100129-Kendriya Vidyalaya,1,4,0,4,0,0,0,0
10,114-DEHRADUN,T34005-Vivekanand Mission PVT ITI,2,4,4,0,4,0,100,100
11,121-CHENNAI,"420058-Kendriya Vidyalaya,",1,4,0,4,0,0,0,0
12,102-PUNE,"110041-Halqua E-dawanik Jr.college,",1,4,0,4,0,0,0,0
13,122-DHARAMSALA,060047-Hill Grove Sr.sec.school,1,4,0,4,0,0,0,0
14,104-GUWAHATI,200029-Ramnagar Higher Sec. School,1,4,1,3,0,1,25,0
15,125-JAMMU,070021-Unique Public Education Centre,1,4,0,4,0,0,0,0
16,107-DELHI,050665-NVN School,1,4,0,4,0,0,0,0
17,106-KOCHI,090090-Govt. Hr.sec.school,1,3,0,3,0,0,0,0
18,120-RANCHI,260204-Noamundi Inter College,1,3,0,3,0,0,0,0
19,107-DELHI,"G27019-SARVODAYA BAL VIDYALAYA SUBHASH NAGAR MOD, NEAR SUBHASH NAGAR METRO STATION NEW DELHI-110027",3,3,0,3,0,0,0,0
20,111-ALLAHABAD/PRAYAGRAJ,T21006-Gangotri Devi ITI JungleDumary No.1,1,3,0,3,0,0,0,0
21,111-ALLAHABAD/PRAYAGRAJ,210774-Nirmal Kesia devi Inter College,1,3,0,3,0,0,0,0
22,114-DEHRADUN,340313-Information Technology Institute for the India,1,3,0,3,0,0,0,0
23,117-BENGALURU,080039-Smt. Shanthabai Edu. Society (R),1,3,0,3,0,0,0,0
24,109-JAIPUR,170198-Govt. Sr. Sec. School,1,3,0,3,0,0,0,0
25,116-VISAKHAPATNAM,T01006-BHARAT ITI ,3,3,3,0,0,3,100,0
26,105-CHANDIGARH,250011-Sharda Sarvihitakari Model Sr.sec.,1,2,0,2,0,0,0,0
27,109-JAIPUR,170314-Naveen Sr.sec.school,1,3,0,3,0,0,0,0
28,114-DEHRADUN,340261-Govt. Inter College,1,3,0,3,0,0,0,0
29,115-BHUBANESWAR,410142-Government High School,3,3,3,0,3,0,100,100
30,114-DEHRADUN,210782-Guru Govind Singh Public School,1,3,0,3,0,0,0,0
31,120-RANCHI,260098-R.k. +2 High School,1,3,0,3,0,0,0,0
32,106-KOCHI,090094-Jr. Baselios English Medium School,2,3,3,0,1,2,100,33.33
33,107-DELHI,050557-Karhana Sr.Sec. School,1,3,0,3,0,0,0,0
34,109-JAIPUR,170175-Govt. Maharawal Sr. Sec. School,3,3,0,3,0,0,0,0
35,109-JAIPUR,170267-Disha Delphi Public School,1,3,0,3,0,0,0,0
36,105-CHANDIGARH,M16079-Dashmesh Khals Sr.sec.school,1,3,0,3,0,0,0,0
37,114-DEHRADUN,T34002-Maharishi Dayanand Pvt. Industrial,1,2,0,2,0,0,0,0
38,115-BHUBANESWAR,150142-Govt. High School,0,0,0,0,0,0,0,0
39,102-PUNE,110137-Kendriya Vidyalaya,1,2,0,2,0,0,0,0
40,119-RAIPUR,290119-Govt. Higher Secondary School,1,2,0,2,0,0,0,0
41,118-GANDHINAGAR,040057-Madhyamik Shala,0,0,0,0,0,0,0,0
42,114-DEHRADUN,T34001-Advanced Training Institute,1,2,0,2,0,0,0,0
43,117-BENGALURU,080054-Shakuntala Patil Residential School,1,2,0,2,0,0,0,0
44,110-PATNA,M38123-Millat Academy,2,2,0,2,0,0,0,0
45,104-GUWAHATI,320118-HQ 44 Mountain Brigade,1,2,0,2,0,0,0,0
46,107-DELHI,270527-Ran Singh Model Public School,1,2,0,2,0,0,0,0
47,102-PUNE,110117-Jawahar Navodaya Vidyalaya,1,2,0,2,0,0,0,0
48,107-DELHI,270330-Rishabh Public School,1,2,0,2,0,0,0,0
49,117-BENGALURU,080070-St. Ann's English School,1,2,0,2,0,0,0,0
50,110-PATNA,030069-Model Inter Vidyalaya,2,2,0,2,0,0,0,0
51,118-GANDHINAGAR,040040-K.R. DOSHI  High School,1,2,2,0,1,1,100,50
52,120-RANCHI,T26009-Gautam Buddha Pvt. ITI,1,2,0,2,0,0,0,0
53,104-GUWAHATI,240024-Kendriya Vidyalaya,1,2,0,2,0,0,0,0
54,105-CHANDIGARH,050537-Bhagat Singh Public School,1,2,0,2,0,0,0,0
55,111-ALLAHABAD/PRAYAGRAJ,T21003-Regional Voc. Training Institute,1,2,0,2,0,0,0,0
56,113-BHOPAL,100261-Maharana Pratap Higher Sec. School,1,2,0,2,0,0,0,0
57,120-RANCHI,T26005-Gurukul Private ITI,1,2,0,2,0,0,0,0
58,111-ALLAHABAD/PRAYAGRAJ,M21295-John Milton Public School,2,2,0,2,0,0,0,0
59,103-KOLKATA,"220085-Ramakrishna Mision Ashrama,",1,2,0,2,0,0,0,0
60,107-DELHI,"G27008-GOVT. CO-ED NEW SEELAMPUR GOVT CO-ED M. S. GURUDWARA ROAD, NEW SEELAMPUR-110053",1,2,0,2,0,0,0,0
61,115-BHUBANESWAR,"410063-Govt. Girls High School,(ssd)",1,2,1,1,1,0,50,50
62,120-RANCHI,T26002-Gandhian Institute of Techonology,1,2,1,1,1,0,50,50
63,103-KOLKATA,220030-Nepali Girls Social Service Centre,1,2,2,0,2,0,100,100
64,107-DELHI,"G27064-Govt. Priyadarshini Sarvodaya Kanya Vidyalaya, Fatehpur Beri, South, Delhi-110074",2,2,0,2,0,0,0,0
65,107-DELHI,M38351-Khadijatul Kubra Girls Public Sch.,1,2,0,2,0,0,0,0
66,105-CHANDIGARH,050523-Mahendra Model School,1,2,0,2,0,0,0,0
67,117-BENGALURU,080081-Gopalan International School,1,2,0,2,0,0,0,0
68,121-CHENNAI,190148-The Indian Public School,0,0,0,0,0,0,0,0
69,106-KOCHI,M09074-Quadisiyya English Medium Madarsa,1,2,0,2,0,0,0,0
70,105-CHANDIGARH,"T16001-Advanced Training Institute,",2,2,0,2,0,0,0,0
71,121-CHENNAI,190163-Maharishi International Residential School,1,2,0,2,0,0,0,0
72,107-DELHI,270204-St. Xavier's Sr.sec.school,1,2,0,2,0,0,0,0
73,105-CHANDIGARH,T05011-Shree Shyamji Private. ITI,1,2,0,2,0,0,0,0
74,121-CHENNAI,420060-Kendriya Vidyalaya,1,2,0,2,0,0,0,0
75,109-JAIPUR,170416-Shree  Kalyan Bal Bharti Sr. Sec. School,1,2,0,2,0,0,0,0
76,119-RAIPUR,290073-Jawahar Navodaya Vidyalaya,1,2,0,2,0,0,0,0
77,105-CHANDIGARH,T05006-BMP Private ITI,1,2,0,2,0,0,0,0
78,107-DELHI,270485-Kendriya Vidyalaya,1,2,0,2,0,0,0,0
79,118-GANDHINAGAR,040131-Glorious Public School,1,2,2,0,1,1,100,50
80,125-JAMMU,070063-Army Public School,1,2,2,0,2,0,100,100
81,111-ALLAHABAD/PRAYAGRAJ,M21444-Eram Intermediate College,2,2,0,2,0,0,0,0
82,121-CHENNAI,190144-kids Club Senior Secondary School,1,2,0,2,0,0,0,0
83,118-GANDHINAGAR,390089-Shree Swaminarayan Academy,1,2,2,0,1,1,100,50
84,117-BENGALURU,M08054-Ali Public English Medium High School,1,2,0,2,0,0,0,0
85,115-BHUBANESWAR,"150172-150172-Govt.Boys High School,Unit-9",1,2,1,1,0,1,50,0
86,107-DELHI,"G27037-R.S.K.V. Shankar Nagar, Gandhi Nagar East, Delhi-110031",1,2,0,2,0,0,0,0
87,108-ABROAD/NIOS HQ,980004-Bridge Academy,1,2,0,2,0,0,0,0
88,120-RANCHI,260170-R.mitra +2 School,1,2,0,2,0,0,0,0
89,107-DELHI,450151-Manovikas School For Inclusion,1,2,0,2,0,0,0,0
90,113-BHOPAL,100194-Ma Veena Vadini Higher Sec. School,1,2,0,2,0,0,0,0
91,105-CHANDIGARH,050087-Arya Sr.sec School,1,2,0,2,0,0,0,0
92,107-DELHI,270110-D A V Centenary Public School,1,1,0,1,0,0,0,0
93,121-CHENNAI,190141-Vanshi Manthan Vidyashram,1,2,0,2,0,0,0,0
94,104-GUWAHATI,020031-Kendriya Vidyalaya,1,2,1,1,0,1,50,0
95,102-PUNE,110138-Kendriya Vidyalaya,1,2,0,2,0,0,0,0
96,110-PATNA,"030245-Buxar High School,",2,2,0,2,0,0,0,0
97,121-CHENNAI,190176-Prasan Vidya Mandir,1,2,0,2,0,0,0,0
98,121-CHENNAI,420051-Kittappa Mpl. Hr. Sec. School,1,1,0,1,0,0,0,0
99,111-ALLAHABAD/PRAYAGRAJ,210699-Karam Devi Memorial Academy,1,1,1,0,0,1,100,0
100,100-NOIDA,270226-Sarvodaya Bal Vidyalaya,1,1,0,1,0,0,0,0
1,107-DELHI,"G27031-Sarvodaya Bal Vidyalaya, Railway Colony Tughlakabad South , New Delhi",1,1,0,1,0,0,0,0
2,111-ALLAHABAD/PRAYAGRAJ,M21578-St. Joseph's Convent School,1,1,1,0,0,1,100,0
3,120-RANCHI,260131-Govt. +2 High School,1,1,0,1,0,0,0,0
4,111-ALLAHABAD/PRAYAGRAJ,210692-Mahatma J.f. Public School,1,1,1,0,0,1,100,0
5,101-HYDERABAD,M38359-Mannu Model School,1,1,0,1,0,0,0,0
6,119-RAIPUR,290046-Kendriya Vidyalaya,1,1,0,1,0,0,0,0
7,110-PATNA,M03400-Angel High School,1,1,0,1,0,0,0,0
8,104-GUWAHATI,130021-Nongthymmai Nepali Higher Sec.,1,1,1,0,0,1,100,0
9,120-RANCHI,260202-RADHA GOVIND PUBLIC SCHOOL,1,1,0,1,0,0,0,0
10,119-RAIPUR,290105-Govt. Higher Secondary School,1,1,0,1,0,0,0,0
11,110-PATNA,030065-Mangal Seminary Inter College,1,1,0,1,0,0,0,0
12,113-BHOPAL,100119-Kendriya Vidyalaya No-1,1,1,0,1,0,0,0,0
13,115-BHUBANESWAR,410086-Govt. High School,1,1,1,0,1,0,100,100
14,114-DEHRADUN,210227-H.s.aggarwal Inter College,1,1,0,1,0,0,0,0
15,107-DELHI,"G27017-GOVT. BOYS SENIOR SEC. SCHOOL, D-BLOCK, NEAR GURUDWARA, PRASHANT VIHAR, DELHI-85",1,1,0,1,0,0,0,0
16,101-HYDERABAD,M01198-Insight International School,1,1,0,1,0,0,0,0
17,107-DELHI,270261-Rajdhani Public School,1,1,0,1,0,0,0,0
18,114-DEHRADUN,340283-The Oxford School,1,1,0,1,0,0,0,0
19,117-BENGALURU,080068-Jindal Vidya Mandir,1,1,0,1,0,0,0,0
20,104-GUWAHATI,M02065-CENTRAL PUBLIC SCHOOL,1,1,1,0,0,1,100,0
21,120-RANCHI,260128-R.k.+2 School,1,1,0,1,0,0,0,0
22,119-RAIPUR,290028-Maharishi Vidya Mandir-i,1,1,0,1,0,0,0,0
23,111-ALLAHABAD/PRAYAGRAJ,210433-Jawahar Navodaya Vidyalaya,1,1,0,1,0,0,0,0
24,114-DEHRADUN,450107-Deaf & Dumb School,1,1,0,1,0,0,0,0
25,110-PATNA,030402-Lohia Nagar Mount Carmel High,1,1,0,1,0,0,0,0
26,111-ALLAHABAD/PRAYAGRAJ,210526-The Ideal New Star English School,0,0,0,0,0,0,0,0
27,109-JAIPUR,170225-Jawahar Navodaya Vidyalaya,1,1,0,1,0,0,0,0
28,122-DHARAMSALA,060029-Govt. Senior Secondary School,1,1,0,1,0,0,0,0
29,104-GUWAHATI,140010-Ibaung Thou Memorial High School,1,1,0,1,0,0,0,0
30,107-DELHI,270439-Govt. Boys Senior Secondary School,1,1,0,1,0,0,0,0
31,105-CHANDIGARH,050384-Apex Public School,1,1,0,1,0,0,0,0
32,125-JAMMU,070053-Vasuki Shiksha Kendra High School,0,0,0,0,0,0,0,0
33,110-PATNA,030077-S.s.balika Ucch Vidyalaya,0,0,0,0,0,0,0,0
34,107-DELHI,"G27057-Govt.Girls Sr.Sec.School, No-2 A-Block Janak Puri New West-B, Delhi-110058",1,1,0,1,0,0,0,0
35,109-JAIPUR,170315-Ajay Shikshan Sansthan Sr.sec.schol,1,1,0,1,0,0,0,0
36,120-RANCHI,260004-Sacred Heart Convent School,1,1,1,0,0,1,100,0
37,107-DELHI,270286-Gyan Sagar Public School,1,1,0,1,0,0,0,0
38,107-DELHI,"G27002-SARVODAYA CO-ED SEC. SCHOOL, I.P. EXT. PATPAR GANJ,DELHI-110092",1,1,0,1,0,0,0,0
39,114-DEHRADUN,340041-Kendriya Vidyalaya No.1,0,0,0,0,0,0,0,0
40,110-PATNA,030390-Jeewan Public School,1,1,0,1,0,0,0,0
41,107-DELHI,"G27050-Govt.Girls Sr.School, Bc-Block Sultan Puri, North West, Delhi-110086",1,1,0,1,0,0,0,0
42,105-CHANDIGARH,050633-Shree Maharaja Aggarsain Public School,1,1,0,1,0,0,0,0
43,107-DELHI,270281-Shaheed Bishan S.memo.sr.sec.school,1,1,0,1,0,0,0,0
44,111-ALLAHABAD/PRAYAGRAJ,210098-Shyam Bihari Singh Inter College,1,1,0,1,0,0,0,0
45,107-DELHI,210709-L.K. International School,1,1,0,1,0,0,0,0
46,110-PATNA,030384-Don Bosco School,1,1,0,1,0,0,0,0
47,114-DEHRADUN,340308-St. J.P. Convent Public School,0,0,0,0,0,0,0,0
48,103-KOLKATA,450043-Raphael Academic & Voc. School,1,1,0,1,0,0,0,0
49,119-RAIPUR,290069-Jawahar Navodaya Vidyalaya,1,1,0,1,0,0,0,0
50,107-DELHI,270306-Rajender Lakra Model School,1,1,1,0,0,1,100,0
51,105-CHANDIGARH,250006-Bal Niketan Model Sr.sec.school,1,1,0,1,0,0,0,0
52,105-CHANDIGARH,M16097-Holy Mary's School,1,1,0,1,0,0,0,0
53,114-DEHRADUN,340176-Vidya Vikasinee Inter College,1,1,0,1,0,0,0,0
54,121-CHENNAI,190071-Govt. Boys Hr.sec. School,1,1,0,1,0,0,0,0
55,107-DELHI,-,1,1,0,1,0,0,0,0
56,121-CHENNAI,190090-Govt. Boys Hr.sec. School,0,0,0,0,0,0,0,0
57,105-CHANDIGARH,160130-Kalgidhar National Sr.Sec.School,1,1,0,1,0,0,0,0
58,107-DELHI,"G27032-Govt.Boys Sr.Sec.School Badarpur Near DDA Flats & Post Office, South (East) Delhi-110044",1,1,0,1,0,0,0,0
59,107-DELHI,270144-Delhi Public School,1,1,0,1,0,0,0,0
60,114-DEHRADUN,340173-Carman Residential & Day School,0,0,0,0,0,0,0,0
61,121-CHENNAI,190120-Sishya School,1,1,0,1,0,0,0,0
62,113-BHOPAL,100191-Narsingh Public Hr. Sec. School,1,1,0,1,0,0,0,0
63,115-BHUBANESWAR,150044-Govt. Higher Secondary School,1,1,1,0,1,0,100,100
