SRNO,REGIONAL CENTRE,AI-CODE AND NAME,TOTAL STUDENTS UPLOADED TMA,TOTAL TMA UPLOADED,TOTAL ALLOCATED SUBJECTS,TOTAL UN-ALLOCATED SUBJECTS,TOTAL EVALUATED SUBJECTS,TOTAL ALLOCATED UN-EVALUATED SUBJECTS,PRE-ALLOCATED,PRE-EVALUATED
1,118-GANDHINAGAR,M04020-Noori Higher Secondary School - Dhrol,490,2827,2827,0,2323,504,100,82.17
2,118-GANDHINAGAR,"M39049-Noori Higher Secondary School,",496,2798,2798,0,2797,1,100,99.96
3,118-GANDHINAGAR,390102-Navyug Vidyalaya,489,2708,2708,0,2542,166,100,93.87
4,109-JAIPUR,170121-Saraswati Vidya Mandir Senior,465,2407,2407,0,2407,0,100,100
5,106-KOCHI,M09040-Crescent Rsidential Higher,504,2325,2323,2,2309,14,99.91,99.31
6,113-BHOPAL,100048-Pragya Higher Secondary School,531,2272,2261,11,2163,98,99.52,95.2
7,109-JAIPUR,170147-Friends Public Sr.sec. School,421,2101,2092,9,2083,9,99.57,99.14
8,104-GUWAHATI,240003-Govt.higher Secondary School,404,2069,2069,0,2067,2,100,99.9
9,106-KOCHI,M09001-Jdt Islam Orphanage,430,2011,2011,0,2011,0,100,100
10,104-GUWAHATI,240001-Govt. Hr. Sec. School,390,1983,1983,0,1960,23,100,98.84
11,104-GUWAHATI,240010-Govt. Higher Sec. School,422,1980,1979,1,1976,3,99.95,99.8
12,103-KOLKATA,460523-Baidyapara High School,400,1968,1967,1,1961,6,99.95,99.64
13,118-GANDHINAGAR,"M38147-Noori Higher Secondary School,",426,1940,1940,0,1842,98,100,94.95
14,103-KOLKATA,460529-Netaji Subhas DAV Public School,355,1938,1938,0,1938,0,100,100
15,109-JAIPUR,170342-Saraswati Adarsh Sr.sec. School,379,1919,1919,0,1919,0,100,100
16,103-KOLKATA,220119-Netaji Subhas DAV Public School,342,1895,1895,0,1895,0,100,100
17,104-GUWAHATI,120018-Royal Academy,423,1832,1832,0,1826,6,100,99.67
18,118-GANDHINAGAR,390155-Shree Swaminarayan Gurukul School,296,1777,1777,0,1484,293,100,83.51
19,109-JAIPUR,170132-Hans International Sr.sec.school,353,1753,1750,3,1750,0,99.83,99.83
20,105-CHANDIGARH,250004-D A V Sr.sec. School,376,1700,1691,9,1691,0,99.47,99.47
21,104-GUWAHATI,300002-Govt. Bungkawn High School,414,1667,1667,0,1660,7,100,99.58
22,103-KOLKATA,M22074-Anglo Arabic Secondary School,367,1647,1643,4,1638,5,99.76,99.45
23,104-GUWAHATI,200001-Shishu Bihar Higher Sec. School,322,1633,1633,0,1393,240,100,85.3
24,106-KOCHI,090082-Kendriya Vidyalaya,342,1633,1633,0,1632,1,100,99.94
25,104-GUWAHATI,240006-Govt. Hr. Sec. School,332,1611,1610,1,1511,99,99.94,93.79
26,104-GUWAHATI,020009-Gohpur Higher Sec. School,349,1590,1589,1,1571,18,99.94,98.81
27,104-GUWAHATI,M02073-Lakshirbond Higher Secondary Madarsa,345,1462,1462,0,1459,3,100,99.79
28,114-DEHRADUN,M38300-Makhdoom Baksh Jamia Islamia,241,1440,1440,0,1440,0,100,100
29,103-KOLKATA,220099-Jawahar Navodaya Vidyalaya,260,1440,1440,0,1439,1,100,99.93
30,103-KOLKATA,460510-Dariapur Imampur Barambol High Sch,287,1438,1438,0,0,1438,100,0
31,106-KOCHI,090045-Kendriya Vidyalaya,302,1410,1409,1,1409,0,99.93,99.93
32,103-KOLKATA,460528-Gitanjali Public School,254,1399,1399,0,1281,118,100,91.57
33,104-GUWAHATI,240021-Kendriya Vidyalaya,252,1377,1376,1,1368,8,99.93,99.35
34,106-KOCHI,M09006-Ansar English School,277,1369,1369,0,1348,21,100,98.47
35,109-JAIPUR,170113-Mahala Residential Public School,265,1368,1368,0,1326,42,100,96.93
36,118-GANDHINAGAR,390116-Shree Sharda Secondary & High. Secondary School,266,1307,1307,0,1049,258,100,80.26
37,103-KOLKATA,220116-Dreamland School,253,1304,1304,0,1231,73,100,94.4
38,106-KOCHI,090081-Kendriya Vidyalaya,278,1303,1303,0,1303,0,100,100
39,109-JAIPUR,170365-Shri Imrat Senior Secondary School,268,1300,1300,0,1300,0,100,100
40,107-DELHI,"450061-Akshya Pratisthan,",271,1294,1294,0,1294,0,100,100
41,118-GANDHINAGAR,390083-Nib School Of Science,222,1274,1271,3,1184,87,99.76,92.94
42,106-KOCHI,090035-Sree Valluvanad Vidya Bhavan,271,1272,1272,0,1272,0,100,100
43,106-KOCHI,090047-Kendriya Vidyalaya,273,1263,1262,1,1262,0,99.92,99.92
44,106-KOCHI,"M09060-M.t.i Central School Pottachira,",263,1262,1262,0,1230,32,100,97.46
45,107-DELHI,270433-Chand Ram Public School,262,1245,1241,4,1240,1,99.68,99.6
46,109-JAIPUR,170309-Marwar Winners Public Sr.sec.school,268,1245,1245,0,1245,0,100,100
47,106-KOCHI,090027-Darussalam Eng. School,259,1231,1231,0,1099,132,100,89.28
48,109-JAIPUR,170105-Global Career Sr.sec. School,267,1222,1222,0,1222,0,100,100
49,109-JAIPUR,170374-Saraswti Bal Niketan Sr.Sec. School,276,1198,1191,7,1191,0,99.42,99.42
50,118-GANDHINAGAR,380281-Saraswat International Academy,245,1195,1195,0,1192,3,100,99.75
51,109-JAIPUR,170102-Swami Nityanand Sr.sec.school,243,1191,1191,0,1191,0,100,100
52,109-JAIPUR,170444-Shri Ram Sr. Sec. School,288,1189,1189,0,1189,0,100,100
53,104-GUWAHATI,140016-Mount Mary Academy,238,1178,1178,0,1178,0,100,100
54,104-GUWAHATI,240019-Kendriya Vidyalaya,230,1157,1157,0,1156,1,100,99.91
55,104-GUWAHATI,240017-Govt. Hr.sec.school,230,1151,1150,1,1136,14,99.91,98.7
56,109-JAIPUR,170360-Marudhara Public Sr.Sec. School,255,1144,1144,0,1144,0,100,100
57,109-JAIPUR,170154-Govt. Sr. Sec. School,233,1138,1138,0,1122,16,100,98.59
58,106-KOCHI,M09071-Islamic Central School,237,1137,1137,0,1119,18,100,98.42
59,109-JAIPUR,170287-Govt. Sr. Sec. School,246,1136,1136,0,1129,7,100,99.38
60,109-JAIPUR,170191-Bhartiya Vidya Mandir Sr.sec.school,228,1135,1135,0,1135,0,100,100
61,106-KOCHI,090064-C.k.m.s.s. Sr. Secondary School,238,1130,1130,0,1130,0,100,100
62,107-DELHI,270405-ARUN MODERN PUBLIC SR.SEC.SCHOOL,244,1122,1113,9,1095,18,99.2,97.59
63,106-KOCHI,090058-Kendriya Vidyalaya,227,1095,1094,1,1094,0,99.91,99.91
64,109-JAIPUR,170051-Bal Vikas Adarsh Sr. Secondary School,243,1089,1089,0,1089,0,100,100
65,106-KOCHI,090034-Vyasa Vidya Peethom,220,1076,1076,0,1042,34,100,96.84
66,104-GUWAHATI,020044-Kendriya Vidyalaya,257,1055,1054,1,930,124,99.91,88.15
67,118-GANDHINAGAR,390097-Om Shanti English Medium School,190,1042,1042,0,928,114,100,89.06
68,104-GUWAHATI,240020-Kendriya Vidyalaya,203,1027,1026,1,1001,25,99.9,97.47
69,106-KOCHI,090015-Bhavan's Vidya Mandir,258,1012,1012,0,1012,0,100,100
70,103-KOLKATA,220114-Gitanjali Public School,195,1006,1006,0,963,43,100,95.73
71,107-DELHI,"270267-Career Public School,473",213,999,993,6,993,0,99.4,99.4
72,104-GUWAHATI,020027-Kendriya Vidyalaya,244,995,993,2,978,15,99.8,98.29
73,118-GANDHINAGAR,040127-Shree Swaminarayan Gurukul School,197,993,993,0,971,22,100,97.78
74,123-GANGTOK,450178-North Bengal Central School,197,993,993,0,984,9,100,99.09
75,107-DELHI,"M27191-IASE, FACULTY OF EDUCATION",216,986,981,5,793,188,99.49,80.43
76,117-BENGALURU,M38041-Al-ameen Educational Society,242,983,983,0,983,0,100,100
77,114-DEHRADUN,M34233-Makhdoom Baksh Jamia Islamia,168,979,979,0,979,0,100,100
78,109-JAIPUR,170446-Seven Star Convent School,211,963,963,0,963,0,100,100
79,103-KOLKATA,220037-The Assembly Of God Church School,219,962,961,1,848,113,99.9,88.15
80,123-GANGTOK,180005-Fiveways School,199,939,939,0,829,110,100,88.29
81,109-JAIPUR,170031-Rajasthan Public Sr.sec. School,183,929,929,0,929,0,100,100
82,102-PUNE,M38343-Maulana Abul Kalam  Azad Residential Urdu High School & Jr College,195,922,922,0,721,201,100,78.2
83,105-CHANDIGARH,050641-Sharde Public School,211,918,918,0,918,0,100,100
84,106-KOCHI,090039-Saraswati Vidya Nikethan Public,203,916,916,0,817,99,100,89.19
85,107-DELHI,270530-J N International School,192,894,894,0,152,742,100,17
86,106-KOCHI,M09108-Al Ameen English School,159,893,893,0,893,0,100,100
87,106-KOCHI,090048-Kendriya Vidyalaya,193,892,892,0,892,0,100,100
88,118-GANDHINAGAR,040068-Om Shanti English Medium School,188,890,890,0,608,282,100,68.31
89,107-DELHI,270489-Satyawati Sood Arya Girls Sr.Sec.,187,889,889,0,469,420,100,52.76
90,118-GANDHINAGAR,M39051-Razvi High School -  Lalpur,148,888,888,0,885,3,100,99.66
91,106-KOCHI,090054-Kendriya Vidyalaya,192,888,888,0,888,0,100,100
92,109-JAIPUR,M17260-St. Francis Sr.Sec. School,171,884,884,0,884,0,100,100
93,107-DELHI,270266-M. Savitri D.sanjeevani Pub School,179,878,871,7,847,24,99.2,96.47
94,109-JAIPUR,170298-Sunrise Public Sr.sec. School,185,876,876,0,876,0,100,100
95,118-GANDHINAGAR,390084-B.N. Zala Vidyalaya,147,876,876,0,749,127,100,85.5
96,118-GANDHINAGAR,390085-Maruti High School,157,874,874,0,820,54,100,93.82
97,106-KOCHI,090012-Travancore Inst.of Sci.& Technology,168,872,872,0,872,0,100,100
98,114-DEHRADUN,210622-Konark Vidyapeeth,174,868,868,0,867,1,100,99.88
99,107-DELHI,270226-Sarvodaya Bal Vidyalaya,179,862,10,852,0,10,1.16,0
100,109-JAIPUR,M17268-Madarsa Qadariya Faiz E Sikandriya,136,859,858,1,858,0,99.88,99.88
101,118-GANDHINAGAR,390103-D.H.K. Mungra Knaya Vidhyalay,149,856,856,0,713,143,100,83.29
102,107-DELHI,270137-Dashmesh Public School,180,856,853,3,819,34,99.65,95.68
103,109-JAIPUR,170284-Mother Land Shikshan Sansthan,168,849,849,0,840,9,100,98.94
104,104-GUWAHATI,240008-Govt. Hr. Sec. School,187,848,848,0,807,41,100,95.17
105,104-GUWAHATI,140013-H M C High School,179,846,846,0,836,10,100,98.82
106,107-DELHI,270454-Gyanodaya Sr. Sec. Public School,162,829,829,0,823,6,100,99.28
107,118-GANDHINAGAR,M39050-Jamia Ayesha Madarsatul Banat - Dhrol,146,829,829,0,828,1,100,99.88
108,117-BENGALURU,M08004-Al-Ameen Educational Society,174,828,828,0,827,1,100,99.88
109,109-JAIPUR,170411-Vinayak Vidhya Mandir Sr. Sec. School,166,816,816,0,816,0,100,100
110,118-GANDHINAGAR,390124-S S School of Science,162,815,815,0,751,64,100,92.15
111,107-DELHI,270542-Angels Public School,167,813,813,0,474,339,100,58.3
112,104-GUWAHATI,200020-Hapania High School,158,808,807,1,689,118,99.88,85.27
113,109-JAIPUR,170332-Shri Krishna Public Sr.sec. School,179,805,805,0,805,0,100,100
114,106-KOCHI,"090029-Progressive English School,",168,798,796,2,727,69,99.75,91.1
115,118-GANDHINAGAR,390095-Ochhavlal Sheth High School,161,791,791,0,744,47,100,94.06
116,107-DELHI,270106-Fr. Agnel School,181,790,788,2,520,268,99.75,65.82
117,104-GUWAHATI,240027-Govt. Secondary School,165,789,788,1,779,9,99.87,98.73
118,105-CHANDIGARH,160106-Rajindra Sr.Sec. Public School,145,788,788,0,788,0,100,100
119,114-DEHRADUN,340253-Banjarawala Dehra Public,169,783,783,0,783,0,100,100
120,107-DELHI,M27477-Victoria Public Sr.sec. School,159,764,696,68,437,259,91.1,57.2
121,107-DELHI,270459-J.B.M. Public School,164,756,750,6,700,50,99.21,92.59
122,107-DELHI,270172-Govt. Boys Sr.secondary School,160,754,740,14,532,208,98.14,70.56
123,118-GANDHINAGAR,040059-B.n. Zala Vidyalaya,148,753,753,0,736,17,100,97.74
124,107-DELHI,050651-S D Public School,175,753,749,4,0,749,99.47,0
125,102-PUNE,280007-Shree Ram High School,150,743,741,2,740,1,99.73,99.6
126,107-DELHI,270529-Sant Gyaneshwar Model School,150,740,740,0,635,105,100,85.81
127,105-CHANDIGARH,050607-RISHIKUL SR. SEC. SCHOOL,167,731,731,0,731,0,100,100
128,104-GUWAHATI,300009-Govt. S. Himem High School,182,729,729,0,714,15,100,97.94
129,106-KOCHI,M09059-Markazul Uloom English School,169,724,724,0,724,0,100,100
130,123-GANGTOK,220015-Marwari Panchayat Charity Trust,157,722,652,70,650,2,90.3,90.03
131,106-KOCHI,090002-M E S Women's College,158,710,710,0,710,0,100,100
132,107-DELHI,270416-G.d Lancer's Public School,151,708,703,5,702,1,99.29,99.15
133,107-DELHI,270318-Saai Memorial Girls School,152,707,707,0,689,18,100,97.45
134,109-JAIPUR,170145-Mahima Bal Bharti Sr.sec.school,126,699,699,0,699,0,100,100
135,115-BHUBANESWAR,"150181-Government High School, koraput",119,698,582,116,398,184,83.38,57.02
136,123-GANGTOK,220041-Vidyasagar Higher Secondary School,133,696,678,18,539,139,97.41,77.44
137,107-DELHI,270406-M.R.L. Senior Secondary School,149,696,696,0,450,246,100,64.66
138,118-GANDHINAGAR,M04021-Razvi High School - Lalpur,141,695,695,0,690,5,100,99.28
139,115-BHUBANESWAR,454101-SRUSTI (Society For Rural Upliftment & Socio  Technological Initiative),123,691,691,0,680,11,100,98.41
140,109-JAIPUR,170420-Yogyata Vihar Sr. Sec. School,154,691,691,0,691,0,100,100
141,107-DELHI,270472-Kasturba Balika Vidyalaya,145,691,691,0,691,0,100,100
142,104-GUWAHATI,130019-Jawahar Navodaya Vidyalaya,140,688,688,0,668,20,100,97.09
143,118-GANDHINAGAR,390092-Saraswati Vidya Mandir,124,688,688,0,683,5,100,99.27
144,106-KOCHI,090053-Vidyadhiraja Vidyapeetom Central,134,686,686,0,686,0,100,100
145,109-JAIPUR,170445-Choudhary Public Sr. Sec. School,148,681,681,0,679,2,100,99.71
146,114-DEHRADUN,340168-Shivedale School,138,670,670,0,670,0,100,100
147,109-JAIPUR,M17215-Maulana Abul Kalam Azad Muslim,135,670,670,0,670,0,100,100
148,107-DELHI,270539-M D Indraprastha Public School,140,662,652,10,649,3,98.49,98.04
149,107-DELHI,270101-ROHTAGI A V SR.SEC.SCHOOL,138,656,655,1,655,0,99.85,99.85
150,106-KOCHI,090078-Janasakthi Public School,143,655,655,0,623,32,100,95.11
151,103-KOLKATA,220128-Mount Litera Zee School,127,654,654,0,5,649,100,0.76
152,104-GUWAHATI,M02074-Gyan Jyoti Higher Secondary School,149,653,653,0,630,23,100,96.48
153,109-JAIPUR,170382-Sh. Jagdamba Sr. Sec. School,140,652,652,0,652,0,100,100
154,107-DELHI,270483-The Vivekanand School,138,650,639,11,587,52,98.31,90.31
155,105-CHANDIGARH,050533-Vishva Bharti Public School,149,650,649,1,564,85,99.85,86.77
156,105-CHANDIGARH,250002-Jan Shiksha Sansthan,141,649,645,4,632,13,99.38,97.38
157,118-GANDHINAGAR,390100-Sh. Galteshwar Mahadev Hr.Sec.Sch,131,647,647,0,646,1,100,99.85
158,103-KOLKATA,460530-Swami Vivekananda Vidyamandir,129,646,646,0,471,175,100,72.91
159,107-DELHI,270128-Kendriya Vidyalaya,138,646,634,12,500,134,98.14,77.4
160,107-DELHI,M21307-Assisi Convent School,135,643,0,643,0,0,0,0
161,105-CHANDIGARH,"M25012-St. Josephs Sr. Sec. School,",141,637,633,4,633,0,99.37,99.37
162,106-KOCHI,090055-Kendriya Vidyalaya,130,636,636,0,636,0,100,100
163,106-KOCHI,M09091-Aliya Senior Secondary School,135,634,634,0,574,60,100,90.54
164,109-JAIPUR,170122-Indian Public Sr.Sec.school,139,634,634,0,634,0,100,100
165,123-GANGTOK,180003-Govt. Senior Secondary School,136,632,632,0,632,0,100,100
166,104-GUWAHATI,M46002-LAKSHIRBOND HIGHER SECONDARY MADARSSA,155,627,627,0,627,0,100,100
167,106-KOCHI,M09092-Infant Jesus Residential School,128,622,622,0,620,2,100,99.68
168,103-KOLKATA,220109-Kendriya Vidyalaya,127,621,621,0,0,621,100,0
169,109-JAIPUR,170283-Bhartiya Shikshan Sansthan Senior,134,620,620,0,620,0,100,100
170,107-DELHI,050621-S R S International School,139,609,607,2,602,5,99.67,98.85
171,107-DELHI,050579-Colonel's Public School,124,605,605,0,552,53,100,91.24
172,105-CHANDIGARH,050563-AISHLY PUBLIC SCHOOL,129,605,600,5,522,78,99.17,86.28
173,107-DELHI,270224-Cosmos Public School,130,605,467,138,0,467,77.19,0
174,109-JAIPUR,170341-Ramsnehi Sr.sec. School,120,604,598,6,598,0,99.01,99.01
175,106-KOCHI,090036-Sree Saraswathy Vidya Mandir,129,604,604,0,604,0,100,100
176,107-DELHI,270134-Kautilya Govt Sarvodaya Bal,120,600,0,600,0,0,0,0
177,107-DELHI,270495-Harcourt Butler Sr. Sec. School,122,597,585,12,582,3,97.99,97.49
178,105-CHANDIGARH,050311-Suraj Senior Secondary School,120,597,597,0,597,0,100,100
179,105-CHANDIGARH,050529-Aastha International Public School,136,591,591,0,581,10,100,98.31
180,106-KOCHI,090026-Sree Vivekananda Higher Sec. School,125,589,589,0,589,0,100,100
181,104-GUWAHATI,140012-St. Joseph's School,119,589,589,0,589,0,100,100
182,109-JAIPUR,170404-BHAGAT SINGH SR. SEC. SCHOOL,108,588,588,0,519,69,100,88.27
183,107-DELHI,270516-St. Kabir Modern School,131,587,579,8,579,0,98.64,98.64
184,109-JAIPUR,170351-Subhash Public Sr.Sec. School,130,586,586,0,586,0,100,100
185,114-DEHRADUN,210467-Sarvodaya Public School,119,579,579,0,579,0,100,100
186,107-DELHI,270205-Seth Bhagwandass Sr.sec.school,132,578,0,578,0,0,0,0
187,107-DELHI,210198-Bloom Public School,124,578,159,419,85,74,27.51,14.71
188,106-KOCHI,M09085-Mao Higher Secondary School Elayur,139,574,574,0,574,0,100,100
189,103-KOLKATA,M46001-St. Augustine's Day School,123,574,574,0,0,574,100,0
190,107-DELHI,270115-Govt. Boys Sr. Sec. School No.-1,122,570,0,570,0,0,0,0
191,106-KOCHI,090049-Kendriya Vidyalaya No-2,111,567,567,0,567,0,100,100
192,109-JAIPUR,170281-Bharti Bal Niketan Sr.sec. School,113,567,567,0,567,0,100,100
193,109-JAIPUR,170428-Sainik Children Academy Sr. Sec. School,114,562,559,3,557,2,99.47,99.11
194,118-GANDHINAGAR,390107-Pragati International School,97,562,561,1,557,4,99.82,99.11
195,107-DELHI,050262-DELHI PUBLIC SCHOOL,160,558,519,39,463,56,93.01,82.97
196,106-KOCHI,090097-Naipunnya Public School,129,556,556,0,556,0,100,100
197,105-CHANDIGARH,M16056-Guru Nanak Public Sr Sec School,124,555,555,0,553,2,100,99.64
198,104-GUWAHATI,020075-Rangkut Krorsing High School,129,553,553,0,465,88,100,84.09
199,109-JAIPUR,170216-Maa Sharda Sr.sec. Public School,109,552,552,0,549,3,100,99.46
200,106-KOCHI,090103-Kendriya Vidyalaya,114,548,548,0,548,0,100,100
201,105-CHANDIGARH,050569-DELHI VIDYAPEETH ,118,547,547,0,547,0,100,100
202,109-JAIPUR,170127-Rajasthan Public School,113,546,546,0,546,0,100,100
203,106-KOCHI,M09099-Holy Grace Academy,118,545,545,0,542,3,100,99.45
204,107-DELHI,270098-Jeewan Jyoti Sr. Sec. School,118,544,544,0,505,39,100,92.83
205,109-JAIPUR,170343-L.b.s. Adarsh Vidhyalaya,111,542,542,0,542,0,100,100
206,107-DELHI,050664-Rao Puran Singh Public School,117,539,532,7,532,0,98.7,98.7
207,109-JAIPUR,170364-Lal Bahadur Shastri Sr. Sec. School,107,539,539,0,539,0,100,100
208,123-GANGTOK,220106-Rabindranath Higher Sec. School,108,536,527,9,527,0,98.32,98.32
209,104-GUWAHATI,200004-R.k. Institution,120,533,533,0,453,80,100,84.99
210,109-JAIPUR,170443-Adarsh Sr. Sec. School,115,532,532,0,532,0,100,100
211,107-DELHI,270209-Rajkiya Sarvodaya Bal Vidyalaya No1,117,527,469,58,330,139,88.99,62.62
212,114-DEHRADUN,M21543-Jamia Qasmia Darul Uloom,92,521,521,0,521,0,100,100
213,105-CHANDIGARH,050476-Baba Mungipa Sr.sec. School,122,513,513,0,449,64,100,87.52
214,114-DEHRADUN,M38342-Jamia Islahul Banaat,86,510,510,0,510,0,100,100
215,107-DELHI,270317-B.R.TYAGI SR.SEC.SCHOOL,110,508,490,18,490,0,96.46,96.46
216,104-GUWAHATI,120031-Mount Everest Hr. Sec. School,105,506,506,0,502,4,100,99.21
217,107-DELHI,270074-Kendriya Vidyalaya,106,505,502,3,381,121,99.41,75.45
218,109-JAIPUR,170053-Nehru Modern Secondary School,114,502,502,0,502,0,100,100
219,103-KOLKATA,460505-Fulbari High School,104,500,500,0,0,500,100,0
220,123-GANGTOK,220058-Paranami Balika Vidya Mandir,104,499,0,499,0,0,0,0
221,120-RANCHI,260184-Saraswati Shishu Vidya Mandir,113,499,499,0,499,0,100,100
222,109-JAIPUR,170347-Adarsh Senior Secondary School,109,498,498,0,498,0,100,100
223,109-JAIPUR,170348-Kamal Vidya Mandir Secondary School,105,497,497,0,497,0,100,100
224,104-GUWAHATI,130012-Douglas Memorial Secondary School,113,497,497,0,405,92,100,81.49
225,104-GUWAHATI,300014-Govt. Leitlangpui Higher Secondary,109,496,495,1,495,0,99.8,99.8
226,114-DEHRADUN,210799-Gurukul Vidyapeeth,98,495,492,3,489,3,99.39,98.79
227,109-JAIPUR,170269-Choudhary Educational Institute,95,494,494,0,494,0,100,100
228,125-JAMMU,070041-Jawahar Navodaya Vidyalaya,115,494,494,0,494,0,100,100
229,121-CHENNAI,190033-Kendriya Vidyalaya,120,494,491,3,208,283,99.39,42.11
230,107-DELHI,270149-Nav Jeevan Adarsh Pub.sr.sec.school,109,493,0,493,0,0,0,0
231,103-KOLKATA,460524-Herobhanga Vidyasagar,99,490,490,0,0,490,100,0
232,114-DEHRADUN,210670-Vidya Bhawan Public School,99,488,488,0,488,0,100,100
233,107-DELHI,270367-Govt Boys Sr.sec School,118,488,0,488,0,0,0,0
234,106-KOCHI,M09084-Al Irshad Sr.sec. English School,112,487,487,0,487,0,100,100
235,103-KOLKATA,220054-North Point Sr.sec.boarding School,103,487,487,0,167,320,100,34.29
236,109-JAIPUR,170437-Choudhary Gharsiram Public School,96,485,485,0,485,0,100,100
237,109-JAIPUR,170290-Gyandeep Adarsh Senior Secondary Sc,93,485,485,0,485,0,100,100
238,104-GUWAHATI,M44001-Jaleswar Girls Higher secondary School,120,482,482,0,482,0,100,100
239,118-GANDHINAGAR,390098-Shree Taxshila Vidyalaya,86,478,478,0,367,111,100,76.78
240,123-GANGTOK,180002-Namchi Govt.sr.sec. School,111,475,385,90,273,112,81.05,57.47
241,107-DELHI,270265-Govt Boys Sr Sec School,101,474,472,2,452,20,99.58,95.36
242,114-DEHRADUN,340162-Queen's Public School,116,472,471,1,464,7,99.79,98.31
243,115-BHUBANESWAR,410128-410128-Town High School,77,471,471,0,453,18,100,96.18
244,106-KOCHI,090038-Vedavyasa Vidyalayam Sr.secondary,105,471,471,0,471,0,100,100
245,107-DELHI,270521-New Delhi Public School,96,471,463,8,463,0,98.3,98.3
246,109-JAIPUR,170328-Shri Adarsh Vidya Mandir Senior,97,469,469,0,469,0,100,100
247,109-JAIPUR,170349-Shri Balaji Public SR.Sec. School,100,466,466,0,465,1,100,99.79
248,104-GUWAHATI,200022-Chailengta H.s.school,94,458,458,0,437,21,100,95.41
249,109-JAIPUR,170393-Pooja International Academy,106,457,454,3,451,3,99.34,98.69
250,120-RANCHI,260015-Dbms Carrer Academy,88,457,457,0,383,74,100,83.81
251,104-GUWAHATI,"020022-Don Bosco High School,",108,457,457,0,452,5,100,98.91
252,104-GUWAHATI,440012-Nabadaya Jatiya Bidyalaya,101,454,454,0,355,99,100,78.19
253,107-DELHI,270220-Kendriya Vidyalaya,100,454,0,454,0,0,0,0
254,121-CHENNAI,M38341-Kh Matriculation Boys Hr.sec.school,109,453,453,0,453,0,100,100
255,113-BHOPAL,100206-Amrit  Vidyapeeth School,95,451,451,0,444,7,100,98.45
256,103-KOLKATA,220004-Bholananda National Vidyalaya,95,451,450,1,388,62,99.78,86.03
257,109-JAIPUR,170312-New Bright Land Public Sr.sec.sch.,87,450,450,0,450,0,100,100
258,107-DELHI,270180-Vasant Valley School,107,450,285,165,234,51,63.33,52
259,105-CHANDIGARH,050429-Modern Senior Secondary School,92,450,450,0,450,0,100,100
260,107-DELHI,270415-Doon Public School,94,447,442,5,428,14,98.88,95.75
261,103-KOLKATA,220011-St.vincent's High& Technical School,107,442,442,0,336,106,100,76.02
262,114-DEHRADUN,340230-Govt. Inter College,99,442,442,0,442,0,100,100
263,105-CHANDIGARH,160038-Shastri Model School,98,441,441,0,432,9,100,97.96
264,107-DELHI,050373-Jyoti Public Sr.secondary School,97,440,440,0,372,68,100,84.55
265,106-KOCHI,090020-T.k.m. Higher Sec. School,95,439,439,0,439,0,100,100
266,109-JAIPUR,170337-Hillgrove Col's Academy,89,438,438,0,438,0,100,100
267,118-GANDHINAGAR,390101-Shree Matruvandan Secondary & Higher Secondary School,88,435,435,0,412,23,100,94.71
268,107-DELHI,270170-Govt. Boys Sr.sec.school,95,435,435,0,435,0,100,100
269,106-KOCHI,"090033-Mahatma Gandhi Public School,",93,431,431,0,431,0,100,100
270,107-DELHI,M21655-Fr. Agnel School,87,429,428,1,428,0,99.77,99.77
271,109-JAIPUR,170251-National Shikshan Sansthan,90,427,427,0,427,0,100,100
272,109-JAIPUR,170326-Pooja Sr.sec. School,89,425,425,0,425,0,100,100
273,107-DELHI,270484-Nalanda Modern Public School,89,424,423,1,102,321,99.76,24.06
274,106-KOCHI,090019-Labour India Public School,94,424,424,0,424,0,100,100
275,105-CHANDIGARH,M05445-Mewat Adarsh Sr.sec. School,92,424,424,0,424,0,100,100
276,107-DELHI,270395-Ch. Baldev Singh Model Sec.school,92,423,422,0,422,0,99.76,99.76
277,106-KOCHI,M09041-Darul Hikam Residential School,85,422,422,0,366,56,100,86.73
278,107-DELHI,270249-Psm Senior Secondary School,92,421,191,230,145,46,45.37,34.44
279,107-DELHI,270125-Kendriya Vidyalaya,91,420,419,1,379,40,99.76,90.24
280,114-DEHRADUN,210618-B.s.m. School,91,420,420,0,420,0,100,100
281,107-DELHI,270507-NAV JEEVAN ADARSH PUBLIC SCHOOL,93,419,38,381,30,8,9.07,7.16
282,106-KOCHI,M09107-Irshadiyya Public School,84,416,416,0,416,0,100,100
283,105-CHANDIGARH,050160-Geeta Sr.sec.school,91,410,409,1,399,10,99.76,97.32
284,107-DELHI,210210-Noida Public Senior Sec.school,87,410,408,2,46,362,99.51,11.22
285,109-JAIPUR,170433-Global Public Sr. Sec. School,81,410,410,0,410,0,100,100
286,106-KOCHI,090017-Sreeniketan Centre For Social,81,408,408,0,381,27,100,93.38
287,117-BENGALURU,080065-Clarence High School,87,405,403,0,387,16,99.51,95.56
288,104-GUWAHATI,020070-Nabadaya Jatiya Bidyalaya,92,400,400,0,398,2,100,99.5
289,123-GANGTOK,189001-Regional Centre-Gangtok,110,399,399,0,229,170,100,57.39
290,104-GUWAHATI,200024-New Hindi Secondary School,83,397,397,0,321,76,100,80.86
291,117-BENGALURU,080022-Delhi Public School,85,392,391,1,390,1,99.74,99.49
292,103-KOLKATA,M22098-St. Augustines Day School,117,392,392,0,84,308,100,21.43
293,111-ALLAHABAD/PRAYAGRAJ,M21351-A.a.khan Memorial Inter College,86,390,390,0,390,0,100,100
294,107-DELHI,050258-Bansi Vidya Niketan Sr. Sec. School,82,389,389,0,389,0,100,100
295,107-DELHI,210748-Ghaziabad Public School,86,387,0,387,0,0,0,0
296,104-GUWAHATI,240016-Govt. Higher Secondary School,86,383,381,2,371,10,99.48,96.87
297,107-DELHI,270382-Remal Public School,84,382,381,1,376,5,99.74,98.43
298,123-GANGTOK,M22096-Scottish Universities Mission,81,381,30,351,0,30,7.87,0
299,114-DEHRADUN,210736-Vishva Bharti Vidyapeeth,73,381,381,0,321,60,100,84.25
300,107-DELHI,270007-Col.satsangi's Kiran Memo. Aipeccs,89,380,379,1,379,0,99.74,99.74
301,103-KOLKATA,"220071-Kendriya Vidyalaya No.1, Afs,",83,379,379,0,379,0,100,100
302,121-CHENNAI,190005-The C.p.ramaswami Aiyar Foundation,89,379,338,41,338,0,89.18,89.18
303,103-KOLKATA,460502-Barasija Fulur Anchal Vidyalaya,72,379,379,0,0,379,100,0
304,107-DELHI,270508-BHARAT MATA SARASWATI BAL MANDIR SCHOOL,82,377,376,1,374,2,99.73,99.2
305,111-ALLAHABAD/PRAYAGRAJ,210430-Jawahar Navodaya Vidyalaya,76,376,376,0,376,0,100,100
306,113-BHOPAL,100050-Arjun Higher,82,375,372,3,0,372,99.2,0
307,107-DELHI,270309-Rahul Model Public School,80,374,368,6,360,8,98.4,96.26
308,118-GANDHINAGAR,040071-V.D.T Girls High School,78,373,373,0,281,92,100,75.34
309,104-GUWAHATI,130018-Tome Memorial Secondary School,88,373,372,1,355,17,99.73,95.17
310,114-DEHRADUN,M21332-Capital Public School,82,373,373,0,373,0,100,100
311,107-DELHI,270398-D V Public School,78,372,372,0,372,0,100,100
312,103-KOLKATA,220038-Don Bosco School,80,370,369,1,0,369,99.73,0
313,107-DELHI,270323-Govt.boys Sr.Sec.School,85,369,359,6,359,0,97.29,97.29
314,107-DELHI,050129-Modern Sr. Secondary School,76,368,368,0,368,0,100,100
315,107-DELHI,270493-Sardar Patel Public Sr. Sec. School,77,367,367,0,356,11,100,97
316,103-KOLKATA,220035-St. Ambrose Vidyalaya,73,366,366,0,364,2,100,99.45
317,109-JAIPUR,170396-Vidya Bharti Sr. Secondary School,76,366,359,7,347,12,98.09,94.81
318,104-GUWAHATI,130027-Jyoti Sroat School,88,366,366,0,353,13,100,96.45
319,104-GUWAHATI,020058-Prabhat Tara Children Eng.academy,86,365,365,0,363,2,100,99.45
320,107-DELHI,050261-Drona Public School,79,364,37,327,0,37,10.16,0
321,106-KOCHI,090067-Jawahar Navodaya Vidyalaya,81,364,363,1,334,29,99.73,91.76
322,103-KOLKATA,220076-Vikram Vidyalaya,71,364,364,0,0,364,100,0
323,115-BHUBANESWAR,410150-KALINGA INSTITUTE OF SOCIAL SCIENCES (KISS),75,363,361,2,311,50,99.45,85.67
324,106-KOCHI,M09110-Markaz Higher Secondary School for Boys,78,362,362,0,362,0,100,100
325,114-DEHRADUN,210698-Adarsh Shiksha Mandir Inter College,77,360,360,0,360,0,100,100
326,103-KOLKATA,220107-Malda Railway High School,77,358,358,0,331,27,100,92.46
327,114-DEHRADUN,M38199-Madarsa Islamia Talimul Quran,80,358,356,2,356,0,99.44,99.44
328,107-DELHI,270486-L.K. International School,76,358,358,0,358,0,100,100
329,109-JAIPUR,170329-Pole Star The School,74,357,357,0,357,0,100,100
330,118-GANDHINAGAR,390122-Brahmani Vidhyalay,71,357,357,0,356,1,100,99.72
331,106-KOCHI,090057-Kendriya Vidyalaya,76,355,355,0,355,0,100,100
332,107-DELHI,270336-Amrita Public School,77,354,0,354,0,0,0,0
333,105-CHANDIGARH,050075-K.c.m Army Sr.sec.school,83,354,352,2,351,1,99.44,99.15
334,114-DEHRADUN,M21505-Jamia Tut Tayyibat Niswan College,64,353,353,0,351,2,100,99.43
335,105-CHANDIGARH,160061-MOTHER CHHANKAUR CONVENT SCHOOL,74,350,350,0,327,23,100,93.43
336,107-DELHI,210215-Green Field Sr.sec.public School,76,350,0,350,0,0,0,0
337,105-CHANDIGARH,250010-Shivalik Public School,81,349,348,1,348,0,99.71,99.71
338,102-PUNE,M11112-Anglo Urdu Boys High School & Jr.,96,349,348,1,348,0,99.71,99.71
339,114-DEHRADUN,340222-R.c.d. Public School,75,344,344,0,301,43,100,87.5
340,125-JAMMU,070007-Kendriya Vidyalaya Leh,81,342,342,0,302,40,100,88.3
341,104-GUWAHATI,140019-Govt. Hr. Sec. School,70,342,342,0,332,10,100,97.08
342,107-DELHI,M27483-Victoria Girls Senior Secondary School,77,342,339,3,339,0,99.12,99.12
343,106-KOCHI,090077-Vimala Hridaya Icse School,72,338,338,0,338,0,100,100
344,104-GUWAHATI,020013-Doomdooma Junior College,90,336,336,0,331,5,100,98.51
345,118-GANDHINAGAR,040043-SUNGRACE VIDHYALAYA,67,335,335,0,264,71,100,78.81
346,103-KOLKATA,220008-Salkia Shri Vikram Balika Vidyalaya,65,335,335,0,334,1,100,99.7
347,105-CHANDIGARH,450173-Govt. Rehabilitation Inst. For Intellectual Disabilities,75,334,334,0,334,0,100,100
348,107-DELHI,210781-Adarsh Gyan Sarovar Public School,75,334,334,0,334,0,100,100
349,111-ALLAHABAD/PRAYAGRAJ,"210302-Mahavir Vidya Mandir Inter College,",74,334,334,0,332,2,100,99.4
350,114-DEHRADUN,340133-T.c.g. Public School,73,333,333,0,317,16,100,95.2
351,105-CHANDIGARH,050631-Sand Grove Sr. Sec. School,76,331,331,0,331,0,100,100
352,103-KOLKATA,220108-Kendriya Vidyalaya,67,330,330,0,0,330,100,0
353,103-KOLKATA,460533-Mount Litera Zee School,60,329,329,0,0,329,100,0
354,106-KOCHI,090051-Vyas Vidyaniketan Central School,66,329,329,0,329,0,100,100
355,114-DEHRADUN,340045-St. Joseph's Academy,84,329,328,1,328,0,99.7,99.7
356,107-DELHI,270462-Adarsh Lakhpat Model Sec. School,71,329,329,0,317,12,100,96.35
357,107-DELHI,270544-R C S Convent School,74,329,329,0,329,0,100,100
358,114-DEHRADUN,210152-Asha Modern School,72,327,322,5,294,28,98.47,89.91
359,107-DELHI,270431-Holy International Sr. Sec. School,68,325,320,0,320,0,98.46,98.46
360,107-DELHI,M21663-AYAN NATIONAL PUBLIC SCHOOL,65,324,298,26,3,295,91.98,0.93
361,102-PUNE,110080-Bharat Education Society,71,324,324,0,324,0,100,100
362,107-DELHI,270509-BHARTI VIDYA NIKETAN PUBLIC SCHOOL,73,323,288,35,267,21,89.16,82.66
363,106-KOCHI,090098-B.R. Memorial Central School,69,322,322,0,282,40,100,87.58
364,107-DELHI,270346-S.d.m. Model Secondary School,73,322,322,0,322,0,100,100
365,109-JAIPUR,170143-Ideal Public School,68,321,321,0,321,0,100,100
366,104-GUWAHATI,120061-BISHNULAL GOVERNMENT HIGH SCHOOL,73,319,319,0,319,0,100,100
367,109-JAIPUR,170033-Lamoria Girls Sec. School,70,317,317,0,317,0,100,100
368,103-KOLKATA,220115-Mal Ideal Hindi High School (h.s.),69,317,315,2,0,315,99.37,0
369,107-DELHI,270426-Pioneer Convent School,71,316,311,5,310,1,98.42,98.1
370,104-GUWAHATI,M02068-AMBARI BAZAR HIGH SCHOOL,75,314,314,0,314,0,100,100
371,109-JAIPUR,170436-Pink Pearl Shikshan Sansthan Sr. Sec. School,64,314,314,0,314,0,100,100
372,105-CHANDIGARH,050576-KOTA PUBLIC SCHOOL,74,313,313,0,260,53,100,83.07
373,117-BENGALURU,M08048-Delhi Public School,73,312,310,2,276,34,99.36,88.46
374,107-DELHI,270344-West Point Model School,64,312,312,0,312,0,100,100
375,104-GUWAHATI,240015-Govt. Higher Secondary School,70,310,310,0,309,1,100,99.68
376,106-KOCHI,090046-Kendriya Vidyalaya No-2,68,309,309,0,285,24,100,92.23
377,105-CHANDIGARH,050647-Vikas Sen Sec. School,72,307,307,0,177,130,100,57.65
378,121-CHENNAI,190006-Measi Matriculation Hr.sec. School,59,306,301,5,136,165,98.37,44.44
379,105-CHANDIGARH,050534-Yaduvanshi Shiksha Niketan,62,306,306,0,306,0,100,100
380,107-DELHI,270502-S.E.S BABA NEBHARAJ SR. SEC. SCHOOL,66,303,287,16,149,138,94.72,49.17
381,104-GUWAHATI,120057-Jawahar Navodaya Vidyalaya,65,301,301,0,280,21,100,93.02
382,105-CHANDIGARH,050577-ASHA DEEP SR. SEC. SCHOOL,67,300,300,0,300,0,100,100
383,125-JAMMU,070045-Srinagar Group of Schools,71,300,299,1,110,189,99.67,36.67
384,104-GUWAHATI,200015-Sabroom Boys Higher Sec. School,59,300,300,0,251,49,100,83.67
385,105-CHANDIGARH,250014-Gyandeep Model Sr.sec. School,68,299,292,7,147,145,97.66,49.16
386,107-DELHI,M38078-Institute of Advanced Studies In Education,61,299,296,3,284,12,99,94.98
387,107-DELHI,270510-HINDON PUBLIC SCHOOL,64,299,297,2,297,0,99.33,99.33
388,121-CHENNAI,190136-The Pupil Saveetha Eco. School,69,297,293,4,194,99,98.65,65.32
389,118-GANDHINAGAR,390106-M V S High school,57,297,297,0,274,23,100,92.26
390,104-GUWAHATI,130002-Sacred Heart Girls Higher Secondary,59,297,296,1,255,41,99.66,85.86
391,105-CHANDIGARH,050296-Maharani Laxmi Bai Neo Convent,65,295,291,4,291,0,98.64,98.64
392,118-GANDHINAGAR,390117-Taxshila Vidyalaya,53,295,295,0,288,7,100,97.63
393,106-KOCHI,M09042-Mar Dionysius Sr.sec.school,67,293,292,1,292,0,99.66,99.66
394,109-JAIPUR,170295-Oxbridge International Sr. Sec. School,68,293,293,0,293,0,100,100
395,105-CHANDIGARH,160087-Genius Public School,69,293,293,0,293,0,100,100
396,118-GANDHINAGAR,040088-Shree Sharda Secondary & High. Secondary School,59,292,292,0,197,95,100,67.47
397,106-KOCHI,090079-Parama Bhajtara Kendriya Vidyalayam,60,292,292,0,258,34,100,88.36
398,114-DEHRADUN,340292-Biswas Red Rose Inter College,65,292,292,0,292,0,100,100
399,102-PUNE,280004-St. Xavier's Academy,66,291,291,0,291,0,100,100
400,105-CHANDIGARH,J05285-District Jail,61,288,286,2,131,155,99.31,45.49
401,107-DELHI,050168-St.soldiers Sr.sec.Public School,62,288,285,3,280,5,98.96,97.22
402,107-DELHI,M27482-Guru Harkrishan Public School,62,287,237,50,185,52,82.58,64.46
403,107-DELHI,270498-Mother Divine Public School,63,287,286,1,286,0,99.65,99.65
404,107-DELHI,270300-Shashi Public Secondary School,62,286,81,203,0,81,28.32,0
405,103-KOLKATA,220096-Vivekanand Mission High School,51,286,286,0,272,14,100,95.1
406,109-JAIPUR,170346-Sainik Vidhya Mandir Sr.sec. School,59,286,286,0,286,0,100,100
407,105-CHANDIGARH,050369-Pooja Modern Sr. Secondary School,65,284,283,1,283,0,99.65,99.65
408,109-JAIPUR,170302-Vandana Bal Vidya Niketan Senior,55,284,284,0,284,0,100,100
409,118-GANDHINAGAR,390110-Govt. Khetivadi Sec. & High Sec. School,71,283,283,0,280,3,100,98.94
410,107-DELHI,270203-R.d. Public Sr.sec.school,58,283,156,127,35,121,55.12,12.37
411,114-DEHRADUN,340272-Govt. Inter College,70,282,282,0,282,0,100,100
412,105-CHANDIGARH,050077-Adarsh Sr.sec.school,62,281,281,0,281,0,100,100
413,114-DEHRADUN,340208-Government Inter College,60,281,279,2,106,173,99.29,37.72
414,103-KOLKATA,220070-Bhetaguri Lal Bahadur Shastri Vidyapith,57,281,281,0,277,4,100,98.58
415,103-KOLKATA,220111-KENDRIYA VIDYALAYA IIMC JOKA,67,281,280,1,184,96,99.64,65.48
416,105-CHANDIGARH,M05300-Mewat Modern Academy,58,278,277,1,276,1,99.64,99.28
417,107-DELHI,210239-Diwakar Model School,55,277,0,277,0,0,0,0
418,109-JAIPUR,170229-Jawahar Navodaya Vidyalaya,64,277,275,2,271,4,99.28,97.83
419,105-CHANDIGARH,050532-Ningania Vidya Mandir High School,59,275,275,0,275,0,100,100
420,103-KOLKATA,220059-Indira Gandhi Memorial Sr.s. School,59,274,274,0,1,273,100,0.36
421,107-DELHI,270463-Mata Kasturi Devi Sr.sec.school,54,273,257,16,252,5,94.14,92.31
422,115-BHUBANESWAR,150192-Centurion University of Technology and Management,44,273,273,0,259,14,100,94.87
423,107-DELHI,270545-Royal International School,59,273,271,2,235,36,99.27,86.08
424,105-CHANDIGARH,160153-Gurdasi Devi Institute of Management & Technology,61,272,272,0,272,0,100,100
425,107-DELHI,270384-St.marks Sr.secondary Public School,56,271,267,4,265,2,98.52,97.79
426,107-DELHI,M27478-New Horizon School,58,271,271,0,235,36,100,86.72
427,118-GANDHINAGAR,M04036-Hanifa School (english Medium),53,270,270,0,209,61,100,77.41
428,111-ALLAHABAD/PRAYAGRAJ,210318-S.s.j.d Inter College,55,269,269,0,269,0,100,100
429,106-KOCHI,"M40008-Jdt Islam Orphanage & High School,",57,269,269,0,269,0,100,100
430,106-KOCHI,090096-Toc H (R) Public School,66,267,267,0,242,25,100,90.64
431,118-GANDHINAGAR,M39053-St. Xavier's Vidya Vihar,51,267,267,0,253,14,100,94.76
432,109-JAIPUR,170271-Shiv Saraswati Sr.sec.vidya Mandir,52,264,264,0,264,0,100,100
433,109-JAIPUR,170409-Gandhi Bal Niketan Sr. Sec. School,63,263,263,0,263,0,100,100
434,109-JAIPUR,170373-Gyandeep Shikshan Sansthan Senior,52,261,261,0,261,0,100,100
435,104-GUWAHATI,130023-Jawahar Navodaya Vidyalaya,56,261,261,0,202,59,100,77.39
436,114-DEHRADUN,M21487-Kissan Public Inter College,57,260,259,1,258,1,99.62,99.23
437,107-DELHI,050132-N.R.Hindu Sr.Sec.School,60,259,259,0,251,8,100,96.91
438,109-JAIPUR,170059-Arunodaya Shikshak Sansthan,56,259,259,0,257,2,100,99.23
439,107-DELHI,270500-Navyug Happy Public School,62,258,258,0,178,80,100,68.99
440,105-CHANDIGARH,050549-Bal Bharati Internationl Public Sch,66,256,256,0,256,0,100,100
441,114-DEHRADUN,340220-Kingston Public School,48,255,255,0,255,0,100,100
442,107-DELHI,270287-Pt. Yadram Sec. Public School,53,255,255,0,124,131,100,48.63
443,103-KOLKATA,460507-Jagadishpur High School,51,254,254,0,249,5,100,98.03
444,114-DEHRADUN,340118-Govt. Inter College Champawat,54,253,253,0,253,0,100,100
445,118-GANDHINAGAR,390104-PRAGATI GIRLS HIGH SCHOOL,60,253,253,0,160,93,100,63.24
446,104-GUWAHATI,"M14017-St. Peter's School,",56,253,253,0,252,1,100,99.6
447,114-DEHRADUN,210586-Lakshya Public School,51,251,251,0,245,6,100,97.61
448,104-GUWAHATI,020007-Kendriya Vidyalaya,53,250,250,0,208,42,100,83.2
449,117-BENGALURU,M08049-Delhi Public School,68,249,248,1,209,39,99.6,83.94
450,120-RANCHI,260097-+2 Zila School,50,249,249,0,249,0,100,100
451,106-KOCHI,090102-Kendriya Vidyalaya,52,249,249,0,249,0,100,100
452,104-GUWAHATI,240026-ZENITH CHILD SCHOOL,58,248,248,0,241,7,100,97.18
453,104-GUWAHATI,020038-Kendriya Vidyalaya,57,247,247,0,217,30,100,87.85
454,115-BHUBANESWAR,410127-Centurion University Of Technology,43,244,244,0,239,5,100,97.95
455,101-HYDERABAD,"470011-T.s.w.rschool Jr.college(b),",51,243,243,0,243,0,100,100
456,109-JAIPUR,"170060-H.r. Memorial Public School,",50,243,243,0,242,1,100,99.59
457,109-JAIPUR,170265-M.d.bhati Saraswati Niketan,51,242,242,0,242,0,100,100
458,109-JAIPUR,170333-Neha Public Sr.sec. School,48,242,242,0,241,1,100,99.59
459,107-DELHI,270381-Saraswati Public Secondary School,54,241,241,0,241,0,100,100
460,114-DEHRADUN,340199-Govt. Inter College,51,241,241,0,241,0,100,100
461,114-DEHRADUN,340321-Subhash Smarak Inter College,49,241,241,0,241,0,100,100
462,114-DEHRADUN,M34253-Madarsa Maulana Abul Kalam Azad,45,240,240,0,240,0,100,100
463,103-KOLKATA,220129-Swami Vivekananda Vidyamandir,49,239,239,0,35,204,100,14.64
464,114-DEHRADUN,340277-Matrabhumi Inter College,53,238,238,0,238,0,100,100
465,107-DELHI,M27481-GURU NANAK PUBLIC SCHOOL,52,237,0,237,0,0,0,0
466,107-DELHI,210440-S S International School,52,237,5,232,5,0,2.11,2.11
467,107-DELHI,270332-Citizen Model School,48,236,234,2,232,2,99.15,98.31
468,107-DELHI,210439-S S K Sr.sec.school,58,236,231,5,97,134,97.88,41.1
469,109-JAIPUR,170123-Shishu Bharti Sr.sec.school,51,236,231,5,228,3,97.88,96.61
470,118-GANDHINAGAR,390115-Prizam School Of Science,48,235,235,0,233,2,100,99.15
471,115-BHUBANESWAR,450122-Srusti Society For Rural,41,234,233,1,232,1,99.57,99.15
472,109-JAIPUR,170250-Swami Vivekanand Sr.sec. School,41,234,234,0,234,0,100,100
473,114-DEHRADUN,210403-Khalsa Public Inter College,56,234,234,0,234,0,100,100
474,104-GUWAHATI,130001-Kendriya Vidyalaya,53,234,234,0,234,0,100,100
475,107-DELHI,270447-D.R.P. Convent Secondary School,49,233,233,0,233,0,100,100
476,107-DELHI,270513-Joseph & Mary  Senior Secondary School,49,233,0,233,0,0,0,0
477,107-DELHI,270147-Mount St. Mary's,51,232,231,1,230,1,99.57,99.14
478,107-DELHI,050255-Tarun Niketan Sr.secondary School,49,232,0,232,0,0,0,0
479,108-ABROAD/NIOS HQ,950018-Time Training Centre,46,232,232,0,232,0,100,100
480,113-BHOPAL,M10228-Deniyat Fadeha  Madarsa,46,232,119,113,0,119,51.29,0
481,121-CHENNAI,190102-Vels Vidyashram,58,231,209,22,201,8,90.48,87.01
482,107-DELHI,210510-Campus School,54,230,230,0,230,0,100,100
483,105-CHANDIGARH,"250003-Shivalik Public School, Mohali",50,228,228,0,227,1,100,99.56
484,107-DELHI,270290-Prince Public School Sr. Sec.school,50,228,0,228,0,0,0,0
485,113-BHOPAL,100184-Sarvodaya Higher Secondary School,54,228,228,0,165,63,100,72.37
486,105-CHANDIGARH,050058-Yog High School,48,227,227,0,227,0,100,100
487,115-BHUBANESWAR,150005-Redwoods English School,42,226,226,0,183,43,100,80.97
488,114-DEHRADUN,340003-Children's Academy,50,224,223,1,84,139,99.55,37.5
489,101-HYDERABAD,470196-Kendriya Vidyalaya,51,224,41,183,2,39,18.3,0.89
490,118-GANDHINAGAR,040037-Shree Swaminarayan Academy,47,223,223,0,149,74,100,66.82
491,102-PUNE,280005-Vivekanand Vidyalaya,40,223,223,0,223,0,100,100
492,107-DELHI,270183-Vanasthali Public School,51,222,222,0,201,21,100,90.54
493,103-KOLKATA,220010-St. Teresa's Secondary School,51,222,220,2,18,202,99.1,8.11
494,120-RANCHI,260171-S.s. +2 High School,55,222,0,222,0,0,0,0
495,109-JAIPUR,170390-Vikram Shikshan Sansthan Sr.Sec.Sch,48,222,222,0,188,34,100,84.68
496,107-DELHI,270291-Maharaja Aggarsain Public School,49,220,220,0,141,79,100,64.09
497,123-GANGTOK,220079-Godwin Modern School,42,218,218,0,197,21,100,90.37
498,105-CHANDIGARH,160022-Punjab Model Sr. Sec School,43,217,216,1,212,4,99.54,97.7
499,117-BENGALURU,M08016-St. John's High School,48,217,217,0,210,7,100,96.77
500,109-JAIPUR,170278-Jagriti Senior Secondary School,49,216,202,14,173,29,93.52,80.09
501,107-DELHI,050473-S.d. Senior Secondary School,50,216,216,0,216,0,100,100
502,123-GANGTOK,180004-Deorali Govt.sr.sec. School,51,215,215,0,171,44,100,79.53
503,118-GANDHINAGAR,040075-Shannen Kids School,48,215,214,1,134,80,99.53,62.33
504,115-BHUBANESWAR,150202-MAHAMAYA JR. COLLEGE,40,214,175,39,123,52,81.78,57.48
505,103-KOLKATA,220016-St. James High School,48,213,213,0,155,58,100,72.77
506,104-GUWAHATI,020076-Bishnu Rabha High School,48,211,211,0,211,0,100,100
507,107-DELHI,M27488-Kalgidhar Khalsa Sr. Sec. School,46,210,209,1,204,5,99.52,97.14
508,107-DELHI,270401-Cosmos School,46,210,0,210,0,0,0,0
509,114-DEHRADUN,340192-Jimp Pioneer School,42,210,210,0,209,1,100,99.52
510,105-CHANDIGARH,050026-New Era Senior Secondary School,53,210,210,0,210,0,100,100
511,107-DELHI,270006-St. Francis De Sales Sr.sec. School,45,209,209,0,151,58,100,72.25
512,109-JAIPUR,170354-OM VIDYA MANDIR SR. SEC. SCHOOL,47,209,209,0,190,19,100,90.91
513,114-DEHRADUN,340143-Mahesha Nand  Bahuguna Inter,45,209,209,0,209,0,100,100
514,113-BHOPAL,100055-Bharat Mata Hr.sec.school,42,208,205,3,205,0,98.56,98.56
515,103-KOLKATA,460516-Midnapore Town School,39,207,207,0,100,107,100,48.31
516,105-CHANDIGARH,050169-Maharishi Vidya Mandir,48,206,205,1,205,0,99.51,99.51
517,105-CHANDIGARH,050660-R.K. International School,49,205,205,0,205,0,100,100
518,117-BENGALURU,M08021-Deffodils High School,38,205,205,0,205,0,100,100
519,111-ALLAHABAD/PRAYAGRAJ,M21353-Saint Kabir Inter College,52,205,205,0,205,0,100,100
520,107-DELHI,M27402-St.marys School,40,205,205,0,203,2,100,99.02
521,121-CHENNAI,450011-The Spastic Society Of Tamilnadu,47,204,190,14,190,0,93.14,93.14
522,105-CHANDIGARH,160113-Himalaya Modern Sr.sec. School,46,203,201,2,199,2,99.01,98.03
523,107-DELHI,270501-NATHU RAM CONVENT SCHOOL,45,203,200,3,43,157,98.52,21.18
524,107-DELHI,050162-SARASWATI SR.SEC.SCHOOL,42,202,110,92,0,110,54.46,0
525,105-CHANDIGARH,160110-H.s.d. Girls Sr. Sec. School,43,202,202,0,202,0,100,100
526,102-PUNE,110115-Navneet Jr. College Of Arts,42,201,201,0,180,21,100,89.55
527,114-DEHRADUN,M21368-Madarsa Islahul Muslimeen,37,201,201,0,201,0,100,100
528,105-CHANDIGARH,M16108-Khalsa Public Sr.Sec. School,45,200,200,0,200,0,100,100
529,107-DELHI,050156-Adharsh Bal Vidya Kendrasr.s.school,44,199,193,6,183,10,96.98,91.96
530,103-KOLKATA,M22100-SAMARITAN MISSION SCHOOL(HIGH),43,199,199,0,186,13,100,93.47
531,103-KOLKATA,220052-Maria's Day School,42,199,199,0,199,0,100,100
532,107-DELHI,270412-B.S.M. Public School,45,198,198,0,157,41,100,79.29
533,104-GUWAHATI,020074-Adarsha Hindi Vidyalaya H.E. School,48,197,196,1,174,22,99.49,88.32
534,107-DELHI,270419-C.r. Oasis Convent School,40,197,197,0,0,197,100,0
535,107-DELHI,050408-S.d.m. High School,43,197,197,0,197,0,100,100
536,114-DEHRADUN,340061-Modern School,49,196,192,4,74,118,97.96,37.76
537,114-DEHRADUN,M38367-Muslim Inter College,49,196,194,2,192,2,98.98,97.96
538,107-DELHI,270341-Jain Bharti Model School,40,196,0,196,0,0,0,0
539,114-DEHRADUN,210212-Modern Public School,42,195,195,0,161,34,100,82.56
540,104-GUWAHATI,M02071-KANCHANPUR MEDHA VIKASH VIDYALAYA,44,195,195,0,195,0,100,100
541,109-JAIPUR,170405-GAYATRI VIDYA MANDIR SR. SEC. SCHOOL,38,194,194,0,194,0,100,100
542,109-JAIPUR,M17272-Khalsa Academy,50,193,192,1,169,23,99.48,87.56
543,107-DELHI,270453-New Sainik Public School,38,191,188,3,178,10,98.43,93.19
544,107-DELHI,270436-B.S.M. Senior Secondary School,41,191,190,1,167,23,99.48,87.43
545,107-DELHI,270467-SIDHHARTHA PUBLIC SCHOOL,41,190,106,84,62,44,55.79,32.63
546,106-KOCHI,090007-Anjali Hindi College,41,189,189,0,177,12,100,93.65
547,109-JAIPUR,170424-Choudhary Bal Sr. Sec. School,46,187,187,0,187,0,100,100
548,107-DELHI,270524-Srilal Convent Sr. Secondary School,40,186,186,0,186,0,100,100
549,113-BHOPAL,M10274-Madarsa Nascent Diniyat,29,184,184,0,184,0,100,100
550,107-DELHI,050601-Doon Bharti Public Sr. sec School,37,184,19,165,0,19,10.33,0
551,118-GANDHINAGAR,040089-Taxshila Vidyalaya,36,183,183,0,183,0,100,100
552,104-GUWAHATI,020036-Kendriya Vidyalaya,40,183,182,1,160,22,99.45,87.43
553,105-CHANDIGARH,050226-Gyan Deep Sr.Sec School,39,182,182,0,42,140,100,23.08
554,104-GUWAHATI,130024-Montfort Hr.secondary School,40,182,182,0,166,16,100,91.21
555,107-DELHI,270526-S.D Hari Mandir Girls Sr. Sec. School,40,182,182,0,182,0,100,100
556,107-DELHI,"270399-Decent Public School, Rohini",41,181,0,181,0,0,0,0
557,104-GUWAHATI,020015-Sree Narasinghasthan High School,36,180,180,0,166,14,100,92.22
558,103-KOLKATA,220025-St. Mary Gorretti Girls' High School,40,179,179,0,2,177,100,1.12
559,107-DELHI,050593-D R A Sr. Secondary School,44,179,179,0,175,4,100,97.77
560,107-DELHI,270360-Holy Convent Sr. Sec School,37,178,178,0,129,49,100,72.47
561,104-GUWAHATI,"200016-Amarpur Boys Hr.sec.school,",34,178,178,0,142,36,100,79.78
562,107-DELHI,210755-COLUMBIA CONVENT INSTITUTE,39,178,0,178,0,0,0,0
563,103-KOLKATA,M38111-Anglo Arabic Secondary School,43,177,176,1,156,20,99.44,88.14
564,105-CHANDIGARH,M05444-Mata Gujri Public School,39,177,177,0,120,57,100,67.8
565,103-KOLKATA,230005-Govt. Senior Secondary School,34,177,176,1,0,176,99.44,0
566,103-KOLKATA,460514-Lakhuria High School,33,176,176,0,0,176,100,0
567,109-JAIPUR,170322-Shivaji Bal Niketan Sr.sec. School,37,176,172,4,170,2,97.73,96.59
568,107-DELHI,050085-Holy Child Sr. Sec. School,35,176,176,0,176,0,100,100
569,105-CHANDIGARH,050445-M. S. Senior Secondary School,37,176,176,0,159,17,100,90.34
570,107-DELHI,"M27376-Carmel Convent School,",38,175,170,5,95,75,97.14,54.29
571,121-CHENNAI,190068-Govt. Boys Higher Secondary School,58,174,0,174,0,0,0,0
572,104-GUWAHATI,020063-Sai Rns Academy,39,174,174,0,162,12,100,93.1
573,106-KOCHI,M09076-Narikkuni English Medium School,35,174,174,0,149,25,100,85.63
574,104-GUWAHATI,120014-Ma Whab Islamic For S.c.pub.school,37,174,174,0,169,5,100,97.13
575,107-DELHI,210249-S.g.public School,38,173,0,173,0,0,0,0
576,104-GUWAHATI,M02069-Jaleswar Girls Higher secondary School,47,173,173,0,173,0,100,100
577,114-DEHRADUN,340126-Govt. Intermediate College,42,172,169,3,131,38,98.26,76.16
578,102-PUNE,M11066-Fr. Agnel Multipurpose School,46,172,171,1,155,16,99.42,90.12
579,109-JAIPUR,170305-Dr. Radhakrishnan Public Sec.school,38,172,170,2,170,0,98.84,98.84
580,105-CHANDIGARH,050108-Arya Senior Secondary School,36,172,172,0,172,0,100,100
581,107-DELHI,270207-Govt Sarvodaya Co Ed.vidyalaya,38,172,0,172,0,0,0,0
582,109-JAIPUR,170392-Adarsh Bal Nikunj Sr.Sec.School,36,172,159,13,150,9,92.44,87.21
583,104-GUWAHATI,140030-Mayangnokcha Govt. Hr.Sec. School,35,171,171,0,164,7,100,95.91
584,107-DELHI,"270388-Brahma Shakti Public School,",35,171,165,6,69,96,96.49,40.35
585,118-GANDHINAGAR,390105-V.D.T Girls High School,32,171,171,0,125,46,100,73.1
586,118-GANDHINAGAR,390077-Saraswat International Academy,37,171,171,0,171,0,100,100
587,105-CHANDIGARH,050649-B.P.R. Public School,34,170,170,0,154,16,100,90.59
588,115-BHUBANESWAR,J15160-Circle Jail,34,169,141,28,141,0,83.43,83.43
589,107-DELHI,"270141-Govt. Sarvodaya Bal Vidyalaya, Ramesh Nagar",37,169,134,35,134,0,79.29,79.29
590,105-CHANDIGARH,050211-Nirmal Sr. Sec. Public School,37,169,169,0,138,31,100,81.66
591,109-JAIPUR,170297-Kamla Shikshan Sansthan,33,168,168,0,168,0,100,100
592,118-GANDHINAGAR,040010-Logos Mission Hr.sec School,40,168,167,1,141,26,99.4,83.93
593,118-GANDHINAGAR,040078-Pragati International School,29,167,167,0,167,0,100,100
594,120-RANCHI,260205-KASIDIH HIGH SCHOOL,34,166,166,0,153,13,100,92.17
595,118-GANDHINAGAR,390086-Ranuj High School,32,166,166,0,163,3,100,98.19
596,118-GANDHINAGAR,M39052-Shama High School,36,166,166,0,165,1,100,99.4
597,104-GUWAHATI,M02023-Mont Fort School,39,165,165,0,124,41,100,75.15
598,106-KOCHI,M09065-Ideal English Hr.sec.school,34,165,165,0,146,19,100,88.48
599,111-ALLAHABAD/PRAYAGRAJ,210182-Bal Vidyapeeth,37,164,160,4,101,59,97.56,61.59
600,105-CHANDIGARH,M16061-Mother Chhan Kaur Convent School,37,164,164,0,164,0,100,100
601,118-GANDHINAGAR,390062-Bright High School,33,164,163,1,138,25,99.39,84.15
602,120-RANCHI,260173-+2 Zila School,36,164,164,0,164,0,100,100
603,102-PUNE,280009-Vivdha Vidya Pratisthan's,32,163,163,0,163,0,100,100
604,102-PUNE,110139-Kendriya Vidyalaya,39,163,162,1,162,0,99.39,99.39
605,114-DEHRADUN,340211-Himalaya Vidya Mandir Sr.sec.school,40,162,162,0,160,2,100,98.77
606,107-DELHI,270540-Bhagat International School,35,162,162,0,162,0,100,100
607,114-DEHRADUN,340316-Sangam Children Academy,36,161,161,0,161,0,100,100
608,117-BENGALURU,080005-St. Ann's High School,33,161,161,0,159,2,100,98.76
609,115-BHUBANESWAR,150006-Daniel Public School,28,161,160,1,145,15,99.38,90.06
610,109-JAIPUR,170272-Vikas Public School,35,161,161,0,161,0,100,100
611,114-DEHRADUN,210694-St. Mary's School,39,160,160,0,158,2,100,98.75
612,113-BHOPAL,"100073-Janta Higher Secondary School,",33,160,160,0,147,13,100,91.88
613,107-DELHI,270408-RICHMONDD GLOBAL SCHOOL,35,159,0,159,0,0,0,0
614,107-DELHI,270154-Govt. Sarvodaya Bal Vidyalaya,35,159,86,73,5,81,54.09,3.14
615,107-DELHI,270531-Daffodil Public School,39,159,158,1,156,2,99.37,98.11
616,114-DEHRADUN,M38268-Jamia Qasmia Darul Uloom,28,158,158,0,158,0,100,100
617,105-CHANDIGARH,050612-Vishwas Nav Sharda Public School,37,158,158,0,158,0,100,100
618,109-JAIPUR,170381-SHIV BAL VIDYA MANDIR SR. SEC. SCHOOL,31,158,158,0,158,0,100,100
619,115-BHUBANESWAR,410130-410130-Brajamohan High School,33,157,148,9,131,17,94.27,83.44
620,118-GANDHINAGAR,390082-SUNGRACE VIDHYALAYA,33,157,157,0,144,13,100,91.72
621,105-CHANDIGARH,050450-Arya Senior Secondary School,35,157,157,0,124,33,100,78.98
622,106-KOCHI,M40006-Ai-ameen College,32,157,157,0,143,14,100,91.08
623,105-CHANDIGARH,M16042-St. Soldier Inter. Convent School,32,156,156,0,144,12,100,92.31
624,105-CHANDIGARH,160078-Jawahar Navodaya Vidyalaya,34,155,155,0,127,28,100,81.94
625,104-GUWAHATI,200010-Kendriya Vidyalaya,41,155,155,0,154,1,100,99.35
626,107-DELHI,270494-U.S.M. Public Sr.Sec. School,29,155,155,0,155,0,100,100
627,123-GANGTOK,220030-Nepali Girls Social Service Centre,28,155,154,1,153,1,99.35,98.71
628,106-KOCHI,M09097-Hsm Higher Secondary School,31,155,155,0,134,21,100,86.45
629,109-JAIPUR,170219-Miranda Secondary School,29,155,155,0,155,0,100,100
630,114-DEHRADUN,340270-Govt. Inter College,32,154,154,0,154,0,100,100
631,104-GUWAHATI,M13019-Nabhajyoti Paham G/A Hr. Sec. School,31,154,154,0,151,3,100,98.05
632,114-DEHRADUN,340191-Dayanand Inter College,32,153,153,0,133,20,100,86.93
633,115-BHUBANESWAR,150199-KALINGA INSTITUTE OF SOCIAL SCIENCES (KISS),33,153,134,19,102,32,87.58,66.67
634,109-JAIPUR,170371-Global International Academy,30,153,153,0,151,2,100,98.69
635,113-BHOPAL,100053-Saraswati Hr. Sec. School Gondkala,34,153,153,0,153,0,100,100
636,103-KOLKATA,230011-Govt. Senior Secondary School,29,153,153,0,0,153,100,0
637,103-KOLKATA,220125-Boon English School,30,152,152,0,0,152,100,0
638,109-JAIPUR,170419-Baldev Public Sr. Sec. School,30,152,152,0,152,0,100,100
639,105-CHANDIGARH,050404-Spring Daisy Convent School,32,152,151,1,151,0,99.34,99.34
640,121-CHENNAI,M19103-Al Hira Model School,34,151,151,0,151,0,100,100
641,125-JAMMU,070022-Bright Furture Higher Secondary,38,151,151,0,134,17,100,88.74
642,107-DELHI,270556-Evergreen Public School,32,149,149,0,149,0,100,100
643,104-GUWAHATI,140015-Eastern School,34,149,149,0,149,0,100,100
644,114-DEHRADUN,210237-Amorha Muslim Girls Inter College,35,149,147,2,47,100,98.66,31.54
645,114-DEHRADUN,210174-AMAR SHAHEED MEMORIAL INTER COLLEGE,34,148,148,0,147,1,100,99.32
646,107-DELHI,270457-Rani Public School,34,148,148,0,126,22,100,85.14
647,114-DEHRADUN,210207-Naveen Kumar Bharti Shishu Upwan Inter College,36,147,147,0,147,0,100,100
648,103-KOLKATA,220103-Budge Budge St. Pauls Day School,29,146,146,0,0,146,100,0
649,103-KOLKATA,220044-Kendriya Vidyalaya,33,146,146,0,0,146,100,0
650,105-CHANDIGARH,050407-A. Xavier's International School,29,145,143,2,35,108,98.62,24.14
651,120-RANCHI,260001-Indian School Of Learning,34,145,145,0,145,0,100,100
652,102-PUNE,280001-Pope John Xxiii High School,26,144,144,0,144,0,100,100
653,115-BHUBANESWAR,150031-Kendriya Vidyalaya,29,144,143,1,137,6,99.31,95.14
654,106-KOCHI,M09104-HAIL MARY ENGLISH MEDIUM Resi. HS School,32,144,144,0,144,0,100,100
655,114-DEHRADUN,210558-Jain Academy,27,144,144,0,144,0,100,100
656,105-CHANDIGARH,160135-G.G.S. Public Sr.Sec. School,32,144,144,0,144,0,100,100
657,105-CHANDIGARH,M16116-GOLDEN PUBLIC SCHOOL,30,143,143,0,143,0,100,100
658,105-CHANDIGARH,050367-Shiksha Bharti Vidya Niketan,32,143,143,0,117,26,100,81.82
659,113-BHOPAL,"M10066-Annie Besant Higher Sec School,",32,142,116,26,0,116,81.69,0
660,109-JAIPUR,170081-Children Sr. School,37,142,133,9,122,11,93.66,85.92
661,102-PUNE,280003-Copuchin Friars Minor Society,26,142,141,1,120,21,99.3,84.51
662,125-JAMMU,070029-Jawahar Navodaya Vidyalaya,33,141,141,0,117,24,100,82.98
663,107-DELHI,270506-C.M. MODEL SCHOOL,30,140,134,6,134,0,95.71,95.71
664,109-JAIPUR,M17091-Jametur Hidaya,30,140,140,0,130,10,100,92.86
665,120-RANCHI,260030-Ramakrishna Mission Ashrama,29,140,140,0,140,0,100,100
666,111-ALLAHABAD/PRAYAGRAJ,210303-Janta Inter College,29,140,140,0,140,0,100,100
667,107-DELHI,050019-Kendriya Vidyalaya No. 1,33,140,0,140,0,0,0,0
668,107-DELHI,270519-Upadhyay Convent School,30,139,139,0,138,1,100,99.28
669,123-GANGTOK,180015-Govt. Senior Secondary School,32,139,139,0,135,4,100,97.12
670,106-KOCHI,090056-Kendriya Vidyalaya,35,139,139,0,139,0,100,100
671,114-DEHRADUN,340311-Ambition Public Sr.Sec. School,32,138,138,0,138,0,100,100
672,120-RANCHI,260075-Vidya Vihar Girls High School,31,137,136,1,136,0,99.27,99.27
673,107-DELHI,270302-Indra Prastha Convent Sr.sec.school,28,137,137,0,137,0,100,100
674,118-GANDHINAGAR,040054-Maruti High School,24,137,137,0,111,26,100,81.02
675,118-GANDHINAGAR,040099-S S School of Science,28,137,137,0,122,15,100,89.05
676,107-DELHI,270461-M.N.B. Modern Secondary School,33,137,136,1,134,2,99.27,97.81
677,105-CHANDIGARH,M16044-Kirpal Sagar Academy,28,137,137,0,137,0,100,100
678,107-DELHI,270468-Sky Hawk International School,29,137,64,73,18,46,46.72,13.14
679,118-GANDHINAGAR,390053-Gracious English,28,136,136,0,136,0,100,100
680,107-DELHI,270537-Tyagi Public School,27,136,136,0,129,7,100,94.85
681,105-CHANDIGARH,050046-Saini Sr.sec.school,27,136,136,0,136,0,100,100
682,109-JAIPUR,170243-Govt. Sardar Hr. Secondary School,29,136,134,2,133,1,98.53,97.79
683,104-GUWAHATI,M13016-St.xavier's Secondary School,29,135,135,0,131,4,100,97.04
684,111-ALLAHABAD/PRAYAGRAJ,M21606-Sri Vardhaman Inter College,26,135,135,0,135,0,100,100
685,120-RANCHI,260046-D A V Kapildev Public School,32,135,0,135,0,0,0,0
686,103-KOLKATA,220078-Vidya Niketan,29,135,134,1,0,134,99.26,0
687,109-JAIPUR,170242-Shahid Amit Bhardwaj Govt. Senior,30,134,134,0,134,0,100,100
688,114-DEHRADUN,340249-Janki Children Academy,29,134,134,0,120,14,100,89.55
689,107-DELHI,270383-Mater Dei School,30,134,0,134,0,0,0,0
690,101-HYDERABAD,470002-St. Vincent High School,27,134,134,0,134,0,100,100
691,114-DEHRADUN,340127-Govt. Inter College,30,133,132,1,110,22,99.25,82.71
692,107-DELHI,210667-Nilgiri Hills Public School,29,133,0,133,0,0,0,0
693,118-GANDHINAGAR,"M04025-Don Bosco High School,",32,133,131,2,92,39,98.5,69.17
694,102-PUNE,M11131-DON BOSCO SENIOR SECONDARY SCHOOL,30,132,125,7,119,6,94.7,90.15
695,106-KOCHI,090101-Kendriya Vidyalaya,27,132,132,0,130,2,100,98.48
696,114-DEHRADUN,340084-Maharishi Vidya Mandir,35,132,127,5,36,91,96.21,27.27
697,123-GANGTOK,180016-Govt. Senior Secondary School,29,130,95,35,91,4,73.08,70
698,115-BHUBANESWAR,410129-410129-Police High School,27,130,121,9,102,19,93.08,78.46
699,109-JAIPUR,170280-Lovely Diamond Senior Sec.school,32,130,130,0,120,10,100,92.31
700,102-PUNE,"110017-M. G. M. Academy's Junior College of Arts, Commerce & Science",29,130,128,2,128,0,98.46,98.46
701,102-PUNE,M11037-Don Bosco High School Jr.College,37,130,129,1,128,1,99.23,98.46
702,109-JAIPUR,170391-Bal Gopal Sr.Sec. School,26,130,130,0,130,0,100,100
703,110-PATNA,"030258-R.m.k. Inter School,",30,129,129,0,126,3,100,97.67
704,102-PUNE,280002-Auxilium High School,28,129,128,1,128,0,99.22,99.22
705,104-GUWAHATI,M02061-Abdul Hasib Higher Secondary School,26,128,128,0,127,1,100,99.22
706,104-GUWAHATI,120028-The Tentha High School,27,128,128,0,128,0,100,100
707,111-ALLAHABAD/PRAYAGRAJ,210034-Kendriya Vidyalaya,33,128,128,0,128,0,100,100
708,110-PATNA,030103-Brijishore Dharnighar Rajkiya Balak,27,127,127,0,104,23,100,81.89
709,105-CHANDIGARH,050640-Shivalik Sr. Sec. School,27,127,127,0,63,64,100,49.61
710,107-DELHI,270491-Rahul Public School,27,127,110,17,97,13,86.61,76.38
711,109-JAIPUR,170285-Newai Vidyapeeth Sr.sec. School,27,126,110,16,110,0,87.3,87.3
712,105-CHANDIGARH,050370-Kalyan Sr.sec. School,28,126,126,0,124,2,100,98.41
713,104-GUWAHATI,240028-Govt. Secondary School,25,126,126,0,119,7,100,94.44
714,115-BHUBANESWAR,410135-410135-AJO HIGH SCHOOL,27,126,126,0,125,1,100,99.21
715,105-CHANDIGARH,050635-The Scholars Public School,32,126,126,0,126,0,100,100
716,114-DEHRADUN,M38160-H.b.h.inter College,32,126,126,0,126,0,100,100
717,105-CHANDIGARH,050583-KAPIL VIDYA MANDIR SR. SEC. SCHOOL,28,126,126,0,76,50,100,60.32
718,110-PATNA,"030325-Mandwari +2 High School,",27,125,125,0,125,0,100,100
719,107-DELHI,210797-Bansraj Model School,29,125,125,0,125,0,100,100
720,117-BENGALURU,M38354-SHAHEEN URDU HIGH SCHOOL,25,125,125,0,125,0,100,100
721,105-CHANDIGARH,J05007-Distt. Jail,23,125,125,0,74,51,100,59.2
722,107-DELHI,050542-Vidya School,25,124,0,124,0,0,0,0
723,121-CHENNAI,M19101-Crescent Matric Hr.sec. School,25,124,124,0,124,0,100,100
724,114-DEHRADUN,210228-Gyandeep Sr.secondary School,26,124,124,0,124,0,100,100
725,110-PATNA,030058-Kendriya Vidyalaya,27,124,124,0,36,88,100,29.03
726,105-CHANDIGARH,050403-Mrcr Public School,31,124,124,0,114,10,100,91.94
727,103-KOLKATA,230004-Government Sr. Secondary School,23,123,123,0,50,73,100,40.65
728,118-GANDHINAGAR,390060-Tree House High School,28,123,123,0,121,2,100,98.37
729,118-GANDHINAGAR,390121-Swami Vivekanand Vidhyalaya,27,123,123,0,115,8,100,93.5
730,111-ALLAHABAD/PRAYAGRAJ,210791-K S Pandey Public Academy,28,122,121,1,120,1,99.18,98.36
731,107-DELHI,210507-Saraswati Shiksha Niketan Inter College,26,122,65,57,0,65,53.28,0
732,106-KOCHI,M40054-Markazul Uloom English School,25,122,122,0,122,0,100,100
733,109-JAIPUR,M17117-Children Sr.sec.school,33,122,122,0,122,0,100,100
734,110-PATNA,030070-+2 M.l.academy,31,122,122,0,91,31,100,74.59
735,107-DELHI,270505-Har Govind Secondary Public School,29,122,122,0,122,0,100,100
736,114-DEHRADUN,340243-Govt. Inter College,28,121,119,2,83,36,98.35,68.6
737,109-JAIPUR,170338-Tagore Public Sr.sec. School,25,120,119,1,119,0,99.17,99.17
738,114-DEHRADUN,340296-Scholar Beam Sr. Sec. School,24,120,120,0,116,4,100,96.67
739,106-KOCHI,M09109-St. John's Public School,26,119,119,0,117,2,100,98.32
740,118-GANDHINAGAR,390074-Nootan Bharti Vidyalaya,22,119,119,0,109,10,100,91.6
741,106-KOCHI,M09088-Iqra Islamic Women's College,24,119,119,0,119,0,100,100
742,107-DELHI,050366-C.D. International School,26,119,0,119,0,0,0,0
743,107-DELHI,210441-S. V. Vidya Mandir Inter College,26,119,119,0,111,8,100,93.28
744,109-JAIPUR,170109-K R Adarsh Sr.Sec.School,30,119,118,1,115,3,99.16,96.64
745,107-DELHI,050663-Modish Public School,30,119,4,115,0,4,3.36,0
746,114-DEHRADUN,340236-M.p. Hindu Inter College,27,119,119,0,119,0,100,100
747,109-JAIPUR,M17270-S.k. Green Wood Shikshan Sansthan,23,119,119,0,117,2,100,98.32
748,105-CHANDIGARH,050632-Divine Light Sr. Sec. School,26,119,119,0,101,18,100,84.87
749,107-DELHI,050053-Bal Vikas High School,29,119,119,0,119,0,100,100
750,107-DELHI,050107-T. T. Public School,24,118,0,118,0,0,0,0
751,107-DELHI,050627-Shivalik Educational Academy,26,118,118,0,93,25,100,78.81
752,114-DEHRADUN,340297-Riverain Public School,27,117,117,0,117,0,100,100
753,109-JAIPUR,170204-Raghuraj Academy,29,117,117,0,117,0,100,100
754,118-GANDHINAGAR,040081-M V S High School,23,117,117,0,76,41,100,64.96
755,107-DELHI,270377-Nav Gian Deep Sr. Sec. Public School,25,117,112,5,83,29,95.73,70.94
756,109-JAIPUR,170144-Tilak Bal Mandir Sr.sec.school,22,117,114,3,97,17,97.44,82.91
757,113-BHOPAL,J10004-Central Jail Bhopal,24,117,109,8,85,24,93.16,72.65
758,105-CHANDIGARH,050128-Nalwa Lovely Public School,26,116,116,0,116,0,100,100
759,107-DELHI,050376-Yadav Academy Public High School,25,116,17,99,0,17,14.66,0
760,107-DELHI,270451-Tulip International School,24,116,0,116,0,0,0,0
761,109-JAIPUR,170062-LBS CONVENT SENIOR SECONDARY SCHOOL,25,116,116,0,113,3,100,97.41
762,121-CHENNAI,190112-B.v.m. Global,25,116,108,8,28,80,93.1,24.14
763,118-GANDHINAGAR,390088-Bansidhar Vidyalaya,27,115,115,0,115,0,100,100
764,121-CHENNAI,190029-Kendriya Vidyalaya,30,115,0,115,0,0,0,0
765,104-GUWAHATI,M02060-Maryam Ajmal Woken's College Of,26,115,115,0,115,0,100,100
766,116-VISAKHAPATNAM,010146-Sri Adithya Junior College,21,114,114,0,114,0,100,100
767,103-KOLKATA,230014-Govt. Model Senior Secondary School,23,114,114,0,0,114,100,0
768,118-GANDHINAGAR,390112-Shree Krishna Secondary Higher Secondary School,19,114,112,2,98,14,98.25,85.96
769,114-DEHRADUN,340215-Govt. Inter College,25,114,113,1,53,60,99.12,46.49
770,103-KOLKATA,230003-Name 5132,23,113,112,1,1,111,99.12,0.88
771,107-DELHI,270479-P.D. Model Senior Secondary School,24,113,0,113,0,0,0,0
772,114-DEHRADUN,M21488-Jamia Farooquia Azizul Uloom,27,112,112,0,112,0,100,100
773,115-BHUBANESWAR,150171-Centurion University Of Technology,24,112,112,0,97,15,100,86.61
774,111-ALLAHABAD/PRAYAGRAJ,210169-Smt. Ram Katori Varshney Inter,25,112,112,0,112,0,100,100
775,121-CHENNAI,190100-Smt. Narbada Devi J. Agarwal,26,112,112,0,110,2,100,98.21
776,106-KOCHI,090070-Jawahar Navodaya Vidyalaya,25,111,111,0,110,1,100,99.1
777,114-DEHRADUN,210763-M.D International School,23,111,111,0,103,8,100,92.79
778,105-CHANDIGARH,160026-Everest Public Sr. Sec. School,26,110,109,1,51,58,99.09,46.36
779,118-GANDHINAGAR,040041-Kendriya Vidyalaya,22,110,110,0,77,33,100,70
780,104-GUWAHATI,020004-Kamrup Academy Hr. Sec. School,26,110,110,0,103,7,100,93.64
781,105-CHANDIGARH,050378-Navyug Shiksha Niketan Sr.Sec.school,27,110,107,3,48,59,97.27,43.64
782,107-DELHI,270528-Yash Vidya Public School,24,109,92,17,92,0,84.4,84.4
783,107-DELHI,"210335-Moolchand Chauhan Public School,",23,109,109,0,109,0,100,100
784,102-PUNE,M38349-Al Ameen English High School,21,108,87,21,57,30,80.56,52.78
785,105-CHANDIGARH,M16060-Rose Mary Convent School,27,108,108,0,106,2,100,98.15
786,104-GUWAHATI,M02076-SL COLLEGIATE HIGH SCHOOL,27,108,108,0,108,0,100,100
787,104-GUWAHATI,020069-Pranab Jubilee College,28,108,108,0,100,8,100,92.59
788,114-DEHRADUN,340115-Govt. Inter Mediate College,25,108,104,4,32,72,96.3,29.63
789,123-GANGTOK,180017-Govt. Senior Secondary School,27,108,108,0,100,8,100,92.59
790,118-GANDHINAGAR,390059-St. Xavier's Social Service Soceity,21,107,107,0,99,8,100,92.52
791,107-DELHI,270068-Kendriya Vidyalaya,23,107,0,107,0,0,0,0
792,107-DELHI,210710-Dolphin Public School,24,107,107,0,107,0,100,100
793,109-JAIPUR,170400-Subodh Vidya Mandir Sr. Sen School,24,106,106,0,106,0,100,100
794,105-CHANDIGARH,160019-S.d.girls Sr. Sec. School,25,106,106,0,106,0,100,100
795,107-DELHI,"270389-B.v.m. Model School,",24,106,99,7,62,37,93.4,58.49
796,103-KOLKATA,220075-Sibpur Ambika Hindi High School,23,106,106,0,0,106,100,0
797,105-CHANDIGARH,160080-Malwa Sr.secondary School,25,106,106,0,106,0,100,100
798,113-BHOPAL,M10091-Maulana Azad Inst. Of Professional,19,105,101,4,58,43,96.19,55.24
799,105-CHANDIGARH,050573-CHARAN SINGH MEMORIAL CONVENT SR. SEC. SCHOOL,21,105,105,0,105,0,100,100
800,107-DELHI,270515-SHAHEED UDHAM SINGH SAMARAK CO-ED SEC. SCHOOL,21,105,105,0,105,0,100,100
801,106-KOCHI,M09073-Mcf Public School,21,105,105,0,105,0,100,100
802,104-GUWAHATI,020050-Jawahar Navodaya Vidyalaya,27,105,105,0,104,1,100,99.05
803,120-RANCHI,260100-Jamshedpur Balika Ucch Vidyalaya,21,105,0,105,0,0,0,0
804,109-JAIPUR,170050-Saraswati Bal Higher Sec. School,21,104,104,0,104,0,100,100
805,117-BENGALURU,M08047-Karunya Independent Pu College,20,104,104,0,91,13,100,87.5
806,107-DELHI,210243-Anamika Girls Hr. Sec. School,20,104,104,0,104,0,100,100
807,110-PATNA,"030288-B.n.collegiate School,",24,104,104,0,38,66,100,36.54
808,123-GANGTOK,180009-Govt. Senior Secondary School,23,104,104,0,104,0,100,100
809,104-GUWAHATI,120023-Sentinel College,21,104,104,0,104,0,100,100
810,114-DEHRADUN,340117-Swatantrata Sangram Senani Shaheed,22,104,104,0,104,0,100,100
811,118-GANDHINAGAR,040093-Sanskartirth Gyanpeeth,23,104,104,0,99,5,100,95.19
812,109-JAIPUR,170398-Bhairav Public Sr. Sec. School,21,103,103,0,103,0,100,100
813,105-CHANDIGARH,050215-Holy Heart Sec School,21,103,102,1,37,65,99.03,35.92
814,105-CHANDIGARH,050589-Modern Hind Sr. Sec. School,23,103,103,0,51,52,100,49.51
815,102-PUNE,110126-SAILEE INTERNATIONAL SCHOOL  & JUNIOR COLLEGE,24,103,103,0,99,4,100,96.12
816,114-DEHRADUN,V34001-Doon Vadic Shiksha Samiti,21,103,101,2,97,4,98.06,94.17
817,111-ALLAHABAD/PRAYAGRAJ,M21474-Shuaib Mohammedia Anglo Oriental,27,102,100,2,73,27,98.04,71.57
818,106-KOCHI,"400001-Progressive English School,",20,102,102,0,97,5,100,95.1
819,114-DEHRADUN,340190-Shri Ravi Dutt Bahuguna High School,22,102,102,0,102,0,100,100
820,107-DELHI,050212-Bhartiya Vidya Niketan Sr.s.school,23,102,0,102,0,0,0,0
821,105-CHANDIGARH,160108-Fortune Convent Sr. Sec. School,22,102,101,1,101,0,99.02,99.02
822,109-JAIPUR,170086-Adarsh Jyoti Vidya Peeth,23,101,101,0,97,4,100,96.04
823,108-ABROAD/NIOS HQ,950028-Kuwait Educational Centre,25,101,0,101,0,0,0,0
824,120-RANCHI,"260067-D.a.v. Model School,",23,101,101,0,76,25,100,75.25
825,109-JAIPUR,170438-Shri Ravinder Nath Tagore Sr. Sec. School,23,101,101,0,100,1,100,99.01
826,107-DELHI,270458-Heera Lal Public School,19,101,0,101,0,0,0,0
827,104-GUWAHATI,300001-Madonna Education Centre,23,101,101,0,91,10,100,90.1
828,109-JAIPUR,170330-Vivekanand Senior Secondary School,23,101,101,0,101,0,100,100
829,102-PUNE,110077-Sri Ma Vidyalaya Patilpada,32,101,97,4,95,2,96.04,94.06
830,118-GANDHINAGAR,390127-Adwait Vidyamandir Jasara,18,100,100,0,93,7,100,93
831,125-JAMMU,070054-Prashant Public High School,23,100,100,0,100,0,100,100
832,114-DEHRADUN,340124-A.n. Jha Govt. Inter College,23,100,99,1,30,69,99,30
833,104-GUWAHATI,M02063-Durabandhi Secondary School,25,100,100,0,100,0,100,100
834,103-KOLKATA,220127-Pearl Rosary School (New),20,100,100,0,73,27,100,73
835,107-DELHI,270543-Himalaya Public Sr. Secondary School,20,99,0,99,0,0,0,0
836,107-DELHI,M27233-Baba Banda Singh Memo. Sec. School,18,99,0,99,0,0,0,0
837,106-KOCHI,400062-Vimla Hridya Icse School,20,99,99,0,99,0,100,100
838,125-JAMMU,070001-Presentation Convent High School,23,99,98,1,73,25,98.99,73.74
839,105-CHANDIGARH,050619-Oxford Public School,22,99,97,2,41,56,97.98,41.41
840,114-DEHRADUN,210672-Dev Krishna Public School,21,99,99,0,85,14,100,85.86
841,102-PUNE,110012-Sandesh Vidyalaya College Of Arts,21,99,99,0,99,0,100,100
842,114-DEHRADUN,340227-Govt. Inter College,21,99,99,0,99,0,100,100
843,115-BHUBANESWAR,410121-Kendriya Vidyalaya,21,99,96,3,78,18,96.97,78.79
844,118-GANDHINAGAR,390108-P R Mukhi Sec. & Hr. Sec. School,21,98,98,0,73,25,100,74.49
845,107-DELHI,210595-Unique International Public School,21,98,92,6,82,10,93.88,83.67
846,114-DEHRADUN,340257-Govt. Inter College,21,98,98,0,47,51,100,47.96
847,107-DELHI,270417-Navyug Convent School,21,97,97,0,97,0,100,100
848,107-DELHI,270492-Adarsh GyanSarover Balika Vidyalaya,21,97,97,0,90,7,100,92.78
849,107-DELHI,"450077-DEEPALAYA Y/4A,",20,97,0,97,0,0,0,0
850,105-CHANDIGARH,050522-Guru Nanak Sr.Sec.School,21,97,97,0,72,25,100,74.23
851,105-CHANDIGARH,J05004-District Jail,19,97,97,0,49,48,100,50.52
852,115-BHUBANESWAR,410119-The Assembly Of God School,17,96,96,0,80,16,100,83.33
853,109-JAIPUR,170430-Gayatri Sr. Sec. School,21,96,94,2,87,7,97.92,90.63
854,105-CHANDIGARH,050662-Indus Public School,22,96,96,0,76,20,100,79.17
855,107-DELHI,210671-Konark Public School,21,96,0,96,0,0,0,0
856,106-KOCHI,400053-Kendriya Vidyalaya,20,96,96,0,96,0,100,100
857,102-PUNE,110145-Akshara International School,29,96,94,2,73,21,97.92,76.04
858,115-BHUBANESWAR,T15010-Centurian Private ITI,48,96,96,0,86,10,100,89.58
859,103-KOLKATA,220048-Kendriya Vidyalaya No. 2,22,96,96,0,96,0,100,100
860,114-DEHRADUN,210804-Paramount Public School,21,95,95,0,95,0,100,100
861,114-DEHRADUN,M34252-Jamia Islahul Banaat,16,95,95,0,82,13,100,86.32
862,125-JAMMU,380108-Govt. Boys Higher Secondary School,21,95,95,0,93,2,100,97.89
863,104-GUWAHATI,020039-Kendriya Vidyalaya,25,95,95,0,87,8,100,91.58
864,118-GANDHINAGAR,040007-Tree House High School,21,95,95,0,60,35,100,63.16
865,107-DELHI,270260-Sant Hari Dass Public School,23,95,1,94,0,1,1.05,0
866,106-KOCHI,M40063-Mao Higher Secondary School Elayur,27,95,95,0,95,0,100,100
867,101-HYDERABAD,"370109-T.s.w.r.school Jr.college(g),",19,95,95,0,95,0,100,100
868,106-KOCHI,400043-Kendriya Vidyalaya No-2,19,95,95,0,95,0,100,100
869,114-DEHRADUN,340303-North Point Children's Academy,20,95,95,0,93,2,100,97.89
870,105-CHANDIGARH,050440-K.n.senior Secondary School,21,94,94,0,94,0,100,100
871,121-CHENNAI,190027-The Vikasa School,20,94,89,5,59,30,94.68,62.77
872,107-DELHI,270490-Hansraj Model School,20,94,94,0,94,0,100,100
873,106-KOCHI,400046-Kendriya Vidyalaya No-1,21,94,94,0,94,0,100,100
874,107-DELHI,270546-N L Public School,21,94,94,0,94,0,100,100
875,125-JAMMU,070002-Kendriya Vidyalaya No.1,23,93,93,0,50,43,100,53.76
876,104-GUWAHATI,300019-Govt. Higher Secondary School,22,93,93,0,84,9,100,90.32
877,118-GANDHINAGAR,"040013-Seth C.l. Hindi High School,",24,93,93,0,78,15,100,83.87
878,107-DELHI,270538-Rama Public School,19,93,90,3,88,2,96.77,94.62
879,107-DELHI,270525-G R M Public School,18,93,61,32,44,17,65.59,47.31
880,107-DELHI,270460-New Sandhya Public School,19,93,72,21,72,0,77.42,77.42
881,103-KOLKATA,220017-Shree Jain Shilpa Shiksha Kendra,18,93,93,0,8,85,100,8.6
882,109-JAIPUR,170358-Kids Club School,23,93,93,0,88,5,100,94.62
883,109-JAIPUR,M38350-Al Suffah Academy Public School,23,92,92,0,92,0,100,100
884,107-DELHI,210771-Diamond Public School,18,92,91,1,73,18,98.91,79.35
885,114-DEHRADUN,210438-Tagore Vidya Peeth Inter College,20,92,92,0,92,0,100,100
886,120-RANCHI,260084-Vimla Pandey Memorial Gyan Niketan,18,92,92,0,5,87,100,5.43
887,114-DEHRADUN,340286-Aryan Vidya Mandir,24,91,91,0,90,1,100,98.9
888,105-CHANDIGARH,M05113-G.t.b. Bal Vidya Mandir Sr.s.school,18,91,91,0,76,15,100,83.52
889,111-ALLAHABAD/PRAYAGRAJ,210316-Maa Shri Mahakali Inter College,22,91,91,0,86,5,100,94.51
890,109-JAIPUR,170167-Govt. Higher Secondary School,20,91,81,10,75,6,89.01,82.42
891,114-DEHRADUN,340171-City Public Inter College,25,91,91,0,86,5,100,94.51
892,109-JAIPUR,M17262-Khawaja Model School,18,90,85,5,76,9,94.44,84.44
893,118-GANDHINAGAR,M04016-St. Xavier's High School,21,90,90,0,69,21,100,76.67
894,121-CHENNAI,190022-The Gandhi Gram Rural Institute,19,90,88,2,77,11,97.78,85.56
895,105-CHANDIGARH,050148-Saraswati Vidya Mandir High School,19,90,90,0,90,0,100,100
896,118-GANDHINAGAR,040058-Nib School Of Science,17,89,89,0,64,25,100,71.91
897,105-CHANDIGARH,160137-Paragon Sr. Sec. School,20,89,89,0,44,45,100,49.44
898,115-BHUBANESWAR,410140-Jawahar  Navodaya Vidyalaya,21,88,85,3,68,17,96.59,77.27
899,111-ALLAHABAD/PRAYAGRAJ,210658-Kalawati Inter College,23,88,88,0,75,13,100,85.23
900,117-BENGALURU,080071-Patel Pre-University College,19,88,88,0,65,23,100,73.86
901,114-DEHRADUN,340298-Adarsh Inter College,20,88,87,1,47,40,98.86,53.41
902,102-PUNE,M11084-Sir Sayyad English High School,18,88,88,0,88,0,100,100
903,105-CHANDIGARH,160141-Shri Deshmesh Public Sr.Sec.School,17,88,88,0,68,20,100,77.27
904,109-JAIPUR,"170200-Govt. Hr. Sec. School, Chittorgarh",18,88,83,5,77,6,94.32,87.5
905,107-DELHI,270503-GYAN SAROVER SEC. BAL VIDYALAYA,21,88,88,0,88,0,100,100
906,104-GUWAHATI,020024-Kendriya Vidyalaya,21,88,88,0,88,0,100,100
907,114-DEHRADUN,M21354-Ahmed Saeed Khan Rifahe Aam Inter,20,88,88,0,85,3,100,96.59
908,107-DELHI,270269-Happy Senior School,22,87,84,3,31,53,96.55,35.63
909,106-KOCHI,400028-Sree Valluvanad Vidya Bhavan,19,87,87,0,87,0,100,100
910,114-DEHRADUN,210251-Agroha Shiksha Niketan Inter,19,87,85,2,30,55,97.7,34.48
911,119-RAIPUR,290094-Govt. Boys Higher Secondary School,18,87,87,0,81,6,100,93.1
912,118-GANDHINAGAR,040001-St.xavier's Social Service Society,20,87,86,1,60,26,98.85,68.97
913,115-BHUBANESWAR,410138-410138-BRAJENDRA HIGH SCHOOL,18,86,85,1,73,12,98.84,84.88
914,103-KOLKATA,220033-Kendriya Vidyalaya,23,86,86,0,53,33,100,61.63
915,107-DELHI,"J05281-District Jail, Faridabad",21,86,0,86,0,0,0,0
916,114-DEHRADUN,340087-Maharishi Vidya Mandir,19,86,86,0,86,0,100,100
917,121-CHENNAI,190109-Maharishi Vidya Mandir Senior,31,85,80,5,74,6,94.12,87.06
918,109-JAIPUR,170160-Gcm Govt. Hr. Sec. School,17,85,85,0,80,5,100,94.12
919,105-CHANDIGARH,050638-Rising Sun Public School,18,85,84,1,24,60,98.82,28.24
920,121-CHENNAI,420089-The Vikasa School,17,85,0,85,0,0,0,0
921,106-KOCHI,400045-Vyas Vidyaniketan Central School,19,85,85,0,85,0,100,100
922,105-CHANDIGARH,050381-Sunshine Public School,18,85,85,0,46,39,100,54.12
923,115-BHUBANESWAR,410122-Oriental Public School,14,85,82,3,67,15,96.47,78.82
924,107-DELHI,210733-Bal Jagat Sr.Sec. School,17,84,84,0,84,0,100,100
925,107-DELHI,270324-EKTA MODEL SECONDARY SCHOOL,16,84,78,6,78,0,92.86,92.86
926,115-BHUBANESWAR,410148-Name 5103,16,84,84,0,76,8,100,90.48
927,107-DELHI,210203-Swami Vivekanandsaraswatividyalaya,16,84,83,1,68,15,98.81,80.95
928,105-CHANDIGARH,050551-Thukral Public Sr. Sec. School ,18,84,84,0,78,6,100,92.86
929,107-DELHI,210334-ROCKWOOD SCHOOL,19,83,79,4,64,15,95.18,77.11
930,106-KOCHI,M40055-M.t.i Central School Pottachira,17,83,83,0,82,1,100,98.8
931,106-KOCHI,090087-Raja Rajeswari Senior Sec.school,17,83,83,0,82,1,100,98.8
932,114-DEHRADUN,340219-Ashu Public Inter College,19,83,83,0,76,7,100,91.57
933,111-ALLAHABAD/PRAYAGRAJ,210380-Bal Niketan Balika Inter College,18,83,79,4,58,21,95.18,69.88
934,103-KOLKATA,460288-Lakhuria High School,17,83,83,0,0,83,100,0
935,105-CHANDIGARH,050654-Satluj Public School,18,83,83,0,83,0,100,100
936,125-JAMMU,070008-Govt. Girls Higher Secondary School,19,83,83,0,38,45,100,45.78
937,106-KOCHI,400041-Kendriya Vidyalaya,21,82,82,0,82,0,100,100
938,120-RANCHI,260074-Dav Public School,19,82,0,82,0,0,0,0
939,108-ABROAD/NIOS HQ,970002-Shantiniketan Indian School,18,82,82,0,81,1,100,98.78
940,102-PUNE,M11129-Reena Mehta College,17,82,82,0,82,0,100,100
941,109-JAIPUR,170388-Sanskar Public Sr.Sec. School,17,81,81,0,81,0,100,100
942,105-CHANDIGARH,M16073-Guru Nanak Convent Sen. Sec. School,18,81,81,0,81,0,100,100
943,105-CHANDIGARH,M05090-Ilyas Public School,21,81,81,0,81,0,100,100
944,120-RANCHI,260086-Jawahar Navodaya Vidyalaya,20,81,2,79,0,2,2.47,0
945,107-DELHI,M21209-Azad Memorial Inter College,18,81,0,81,0,0,0,0
946,105-CHANDIGARH,050078-Buniyad Senior Secondary School,18,81,81,0,77,4,100,95.06
947,114-DEHRADUN,210280-Mansarover Girls Inter College,21,80,80,0,72,8,100,90
948,121-CHENNAI,190156-DAV Boys Sr. Secondary School,20,80,80,0,71,9,100,88.75
949,107-DELHI,050221-VIVEK VIDYA SADAN SR.SEC SCHOOL,17,80,0,80,0,0,0,0
950,106-KOCHI,M40034-Crescent Rsidential Higher,20,80,79,1,69,10,98.75,86.25
951,105-CHANDIGARH,050387-Rao Jai Ram Sr.sec. School,16,80,80,0,80,0,100,100
952,117-BENGALURU,080075-Sindhi High School,19,79,79,0,79,0,100,100
953,125-JAMMU,070055-Shishu Niketan Sr. Sec. School,18,79,78,1,59,19,98.73,74.68
954,103-KOLKATA,220100-Kankinara Himayatul Ghurba,15,79,79,0,74,5,100,93.67
955,113-BHOPAL,100196-Abhyuday Sr. Sec. School,19,79,78,1,77,1,98.73,97.47
956,105-CHANDIGARH,160120-NRI Public School,18,79,79,0,78,1,100,98.73
957,106-KOCHI,M40010-Ansar English School,17,79,79,0,71,8,100,89.87
958,118-GANDHINAGAR,390119-Shree Aditya Secondary & High School,17,79,79,0,61,18,100,77.22
959,114-DEHRADUN,340069-Kendriya Vidyalaya,19,79,79,0,79,0,100,100
960,114-DEHRADUN,M34255-RAMSAY INTER COLLEGE,20,78,78,0,68,10,100,87.18
961,105-CHANDIGARH,050480-Saraswati High School,20,78,78,0,78,0,100,100
962,125-JAMMU,380266-Srinagar Group of Schools,19,78,75,3,34,41,96.15,43.59
963,114-DEHRADUN,340202-Government Inter College,17,78,78,0,78,0,100,100
964,121-CHENNAI,190116-Lakshmi Garden Matric Hr.Sec.School,16,78,73,5,47,26,93.59,60.26
965,106-KOCHI,M40031-Mar Ivonios Bethany School,16,78,78,0,74,4,100,94.87
966,114-DEHRADUN,M38366-Mesco Public School,19,78,78,0,78,0,100,100
967,105-CHANDIGARH,160036-Suman Dav-boarding Public School,16,78,77,1,77,0,98.72,98.72
968,114-DEHRADUN,340212-Kendriya Vidyalaya,17,78,75,3,36,39,96.15,46.15
969,120-RANCHI,260077-Kerala Public School,15,77,74,3,7,67,96.1,9.09
970,110-PATNA,030071-S.n.singh Dev. N.g.,18,77,77,0,22,55,100,28.57
971,109-JAIPUR,170397-Lo.Ti. Sr.Sec. School,15,77,75,2,71,4,97.4,92.21
972,107-DELHI,210716-Milton Academy Jr. High School,15,77,76,1,6,70,98.7,7.79
973,114-DEHRADUN,340294-Guru Nanak Mission Public School,18,77,71,6,69,2,92.21,89.61
974,109-JAIPUR,170318-Sant Vidya Nand Sr.sec.sch.& Hostel,17,77,77,0,77,0,100,100
975,107-DELHI,450019-Amar Jyoti Rehablitation & Research,20,77,72,5,33,39,93.51,42.86
976,107-DELHI,270534-R M Arya Girls Sr. Secondary School,17,77,71,6,69,2,92.21,89.61
977,120-RANCHI,260042-Subhash Public School,20,77,74,3,74,0,96.1,96.1
978,105-CHANDIGARH,M16112-SOHRAB PUBLIC SCHOOL ,16,76,74,2,60,14,97.37,78.95
979,106-KOCHI,400049-Kendriya Vidyalaya,17,76,76,0,76,0,100,100
980,105-CHANDIGARH,050332-Sunrise Modern School,18,76,75,1,21,54,98.68,27.63
981,107-DELHI,050316-S.r. Sr.sec. School,16,76,70,6,70,0,92.11,92.11
982,125-JAMMU,070015-Govt. Boys Higher Secondary School,19,76,76,0,76,0,100,100
983,122-DHARAMSALA,060083-Blue Star Public Sr.sec. School,17,76,67,9,58,9,88.16,76.32
984,109-JAIPUR,170413-Saraswati Vidya Mandir Sr. Sec. School,15,75,75,0,75,0,100,100
985,103-KOLKATA,220124-Durgapur Iswar Chandra Vidyasagar (DICV) Public School,17,75,75,0,66,9,100,88
986,106-KOCHI,400039-Kendriya Vidyalaya,16,75,75,0,75,0,100,100
987,111-ALLAHABAD/PRAYAGRAJ,210479-Shri Sovaran Singh Ratani Devi,19,75,75,0,58,17,100,77.33
988,105-CHANDIGARH,050570-SHRI KRISHAN PUBLIC SCHOOL,18,75,75,0,61,14,100,81.33
989,121-CHENNAI,190127-B.V.M. Global,16,75,72,3,44,28,96,58.67
990,102-PUNE,M11018-Guru Govind Singh Public School,15,75,75,0,69,6,100,92
991,121-CHENNAI,190107-KH MATRICULATION BOYS HR. SEC. SCHOOL`,16,74,74,0,71,3,100,95.95
992,106-KOCHI,M40036-Mar Dionysius Sr.sec.school,16,74,74,0,72,2,100,97.3
993,103-KOLKATA,220122-Aaloke Bharti Model School,16,74,74,0,0,74,100,0
994,111-ALLAHABAD/PRAYAGRAJ,210172-Gayatri Samarak Public School,15,74,73,1,72,1,98.65,97.3
995,106-KOCHI,M40068-Infant Jesus Residential School,17,74,74,0,72,2,100,97.3
996,121-CHENNAI,190104-Lalaji Memorial Omega International,39,74,74,0,73,1,100,98.65
997,123-GANGTOK,450043-Raphael Academic & Voc. School,17,74,63,11,0,63,85.14,0
998,114-DEHRADUN,340198-Govt. Inter College damta,19,74,74,0,74,0,100,100
999,103-KOLKATA,230007-Govt. Senior Secondary School,13,74,74,0,70,4,100,94.59
1000,109-JAIPUR,170301-Ramnivas Vidya Mandir Sr.sec.school,15,74,74,0,74,0,100,100
1001,107-DELHI,270425-Mount Abu Public School,16,73,73,0,71,2,100,97.26
1002,118-GANDHINAGAR,390120-Maharshi Vidhyalaya,14,73,73,0,50,23,100,68.49
1003,106-KOCHI,"400023-Labour India Public School,",17,73,73,0,72,1,100,98.63
1004,102-PUNE,110085-Dr.kalmadi Shamarao High School,20,73,73,0,73,0,100,100
1005,107-DELHI,270122-PUSA PUBLIC SR.SEC.SCHOOL,14,73,51,22,51,0,69.86,69.86
1006,106-KOCHI,400019-Mahatma Gandhi Public School,14,73,73,0,73,0,100,100
1007,107-DELHI,270242-M.n.convent Sr.sec.school,17,73,0,73,0,0,0,0
1008,105-CHANDIGARH,050442-Golden Crescent Public School,17,72,72,0,24,48,100,33.33
1009,107-DELHI,210289-C.c.s Vidya Mandir Girl's,14,72,72,0,32,40,100,44.44
1010,114-DEHRADUN,340167-Sanjay Public Intermediate College,11,72,72,0,21,51,100,29.17
1011,114-DEHRADUN,210246-R.s.d. Academy Public School,15,72,72,0,72,0,100,100
1012,105-CHANDIGARH,160016-Rabindra Day Boarding Ss.pub.school,15,72,72,0,71,1,100,98.61
1013,114-DEHRADUN,340142-M.d. Inter College,16,72,72,0,27,45,100,37.5
1014,109-JAIPUR,170276-Shri Bhagwati Vaidya Mandir,13,72,72,0,72,0,100,100
1015,118-GANDHINAGAR,390087-Janki Vidyalaya,20,71,71,0,60,11,100,84.51
1016,115-BHUBANESWAR,150174-Town High School,11,71,71,0,65,6,100,91.55
1017,107-DELHI,210649-S.b.n. Public School,17,71,0,71,0,0,0,0
1018,121-CHENNAI,190125-Blossom Public School,15,71,70,1,69,1,98.59,97.18
1019,110-PATNA,"030329-Rajkiya +2 High School,",14,71,71,0,32,39,100,45.07
1020,107-DELHI,210096-Saraswati Bal Mandir Sr.sec.school,15,71,0,71,0,0,0,0
1021,107-DELHI,270219-Kendriya Vidylaya,18,70,6,64,6,0,8.57,8.57
1022,107-DELHI,450072-Prayas Juvenile Aid Centre,17,70,17,53,1,16,24.29,1.43
1023,106-KOCHI,090100-Siddartha Central School,15,70,70,0,70,0,100,100
1024,114-DEHRADUN,M38358-Madarsa Islahul Muslimeen,19,70,70,0,70,0,100,100
1025,104-GUWAHATI,130008-Mizo Modern High School,16,70,70,0,57,13,100,81.43
1026,115-BHUBANESWAR,410146-Chitalo Mohavidyalaya,14,70,65,5,52,13,92.86,74.29
1027,120-RANCHI,260032-St. Xaviers High School,14,69,69,0,69,0,100,100
1028,108-ABROAD/NIOS HQ,950012-My Capital Educational Facilities Management Facilities Management,15,69,69,0,69,0,100,100
1029,110-PATNA,030074-Zila School,15,69,69,0,26,43,100,37.68
1030,114-DEHRADUN,340169-Saigrace Academy International,16,69,68,1,24,44,98.55,34.78
1031,101-HYDERABAD,M47019-Al-Ameen Jr. Degree College,21,68,68,0,68,0,100,100
1032,115-BHUBANESWAR,J15165-Spl. Jail Bhubaneswar,14,68,59,9,47,12,86.76,69.12
1033,104-GUWAHATI,020065-KENDRIYA VIDYALAYA,15,67,67,0,58,9,100,86.57
1034,123-GANGTOK,180001-Govt. Senior Secondary School,15,67,66,1,50,16,98.51,74.63
1035,110-PATNA,030368-Jawahar Navodaya Vidyalaya,15,67,67,0,67,0,100,100
1036,102-PUNE,110073-Symbiosis,19,66,66,0,66,0,100,100
1037,107-DELHI,270554-G R International School,18,66,55,11,51,4,83.33,77.27
1038,105-CHANDIGARH,J05282-Central Jail,14,66,66,0,25,41,100,37.88
1039,107-DELHI,210715-J.P. International School,14,66,0,66,0,0,0,0
1040,119-RAIPUR,290169-Colonel's Academy of Radiant Education,13,66,66,0,37,29,100,56.06
1041,120-RANCHI,260045-Pvss Dav Public School,14,66,5,61,0,5,7.58,0
1042,117-BENGALURU,080027-National Public High School,17,66,66,0,39,27,100,59.09
1043,103-KOLKATA,450028-M.k.r.&r.indtit For The Handicapped,15,66,66,0,0,66,100,0
1044,106-KOCHI,"400018-Darussalam English School,",14,65,65,0,62,3,100,95.38
1045,109-JAIPUR,170324-L.b.s. Academy Sr.sec. School,12,65,65,0,64,1,100,98.46
1046,105-CHANDIGARH,050524-Adarsh Senior Secondary School,14,65,65,0,65,0,100,100
1047,120-RANCHI,260180-+2 High School,13,65,64,1,61,3,98.46,93.85
1048,111-ALLAHABAD/PRAYAGRAJ,210539-Oxford Public School,16,65,64,1,50,14,98.46,76.92
1049,107-DELHI,050190-S.d.modern Sr.sec.school,14,65,0,65,0,0,0,0
1050,118-GANDHINAGAR,040095-Maharshi Vidhyalaya,13,65,65,0,46,19,100,70.77
1051,107-DELHI,270435-Bal Vidya Model School,14,65,64,1,59,5,98.46,90.77
1052,103-KOLKATA,220014-Caesar School,13,64,64,0,0,64,100,0
1053,104-GUWAHATI,200019-Melagarh H.s.school,13,64,64,0,57,7,100,89.06
1054,107-DELHI,270423-Aryan International School,14,64,0,64,0,0,0,0
1055,118-GANDHINAGAR,390118-Ankur Vidhyalaya,13,64,64,0,64,0,100,100
1056,108-ABROAD/NIOS HQ,910001-International Indian School,13,64,64,0,63,1,100,98.44
1057,121-CHENNAI,310009-Aditya Vidhyashram Residential Sch.,13,63,44,19,11,33,69.84,17.46
1058,107-DELHI,270465-R.P. Memorial Public Sr.Sec.School,15,63,62,1,38,24,98.41,60.32
1059,115-BHUBANESWAR,150194-Centurian University Of Technology,13,63,63,0,51,12,100,80.95
1060,116-VISAKHAPATNAM,010175-Sri Sai Baba Junior College,11,63,62,1,62,0,98.41,98.41
1061,106-KOCHI,400021-T.k.m Higher Sec.school,12,63,63,0,63,0,100,100
1062,105-CHANDIGARH,160159-Dashmesh Sr. Sec. School,15,63,63,0,63,0,100,100
1063,110-PATNA,"030249-V.m. Inter College,",13,62,62,0,62,0,100,100
1064,114-DEHRADUN,210208-Muslim Inter College,13,62,60,2,60,0,96.77,96.77
1065,102-PUNE,110064-The Lord's English High School,17,62,61,1,54,7,98.39,87.1
1066,107-DELHI,270517-M R BhartiModel Sr. Secondary School,13,62,62,0,0,62,100,0
1067,105-CHANDIGARH,050117-Shivalik Senior Secondary School,16,62,62,0,62,0,100,100
1068,109-JAIPUR,170308-Vivek Vidhya Mandir Sr.sec.school,13,62,62,0,62,0,100,100
1069,111-ALLAHABAD/PRAYAGRAJ,210540-Shree Mahaprabhu Public School,15,62,62,0,62,0,100,100
1070,106-KOCHI,090024-Trinity Lyceum,14,62,62,0,60,2,100,96.77
1071,110-PATNA,030276-Patna High School +2,15,62,62,0,17,45,100,27.42
1072,107-DELHI,270407-Modern New Delhi Public School,14,62,62,0,62,0,100,100
1073,107-DELHI,450060-National Association For The Blind,15,62,62,0,62,0,100,100
1074,105-CHANDIGARH,160066-Pine Grove Public School,15,62,62,0,46,16,100,74.19
1075,104-GUWAHATI,"020017-Diphu Commercial College,",14,62,62,0,57,5,100,91.94
1076,118-GANDHINAGAR,040055-Janki Vidyalaya,14,61,60,1,51,9,98.36,83.61
1077,115-BHUBANESWAR,150013-The Assembly Of God School,12,61,61,0,36,25,100,59.02
1078,107-DELHI,270129-Prerana Public Secondary School,13,61,0,61,0,0,0,0
1079,104-GUWAHATI,440007-Doomdooma Junior College,14,61,61,0,50,11,100,81.97
1080,113-BHOPAL,100076-Akshay Academy Hr. Secondary School,15,61,0,61,0,0,0,0
1081,104-GUWAHATI,130014-Kendriya Vidyalaya,15,61,61,0,59,2,100,96.72
1082,111-ALLAHABAD/PRAYAGRAJ,210537-Jamuna Prasad Girls Inter College,14,61,61,0,61,0,100,100
1083,107-DELHI,270520-Sevti Devi Memorial Vidya Mandir,14,61,2,59,1,1,3.28,1.64
1084,105-CHANDIGARH,160039-Jamuna Model Sr. Sec. School,14,60,60,0,60,0,100,100
1085,106-KOCHI,M09100-MGM CENTRAL SCHOOL,14,60,60,0,53,7,100,88.33
1086,103-KOLKATA,M22097-Chachanda B.j. High School,10,60,60,0,60,0,100,100
1087,105-CHANDIGARH,250013-Aanchal International School,19,60,59,1,45,14,98.33,75
1088,118-GANDHINAGAR,040003-Asoplav Nidhi,14,60,59,1,44,15,98.33,73.33
1089,104-GUWAHATI,M30011-Sacred Heart School,15,60,60,0,60,0,100,100
1090,107-DELHI,270310-Bharat Shakti Public School,13,60,60,0,60,0,100,100
1091,105-CHANDIGARH,160035-F.s. Mann Silver Greek School,13,60,60,0,60,0,100,100
1092,110-PATNA,M03114-Red Carpet High School,14,59,59,0,29,30,100,49.15
1093,115-BHUBANESWAR,150195-Suddhananda Vidyalaya,12,59,57,2,47,10,96.61,79.66
1094,104-GUWAHATI,140032-Govt. Higher Secondary school,14,59,59,0,59,0,100,100
1095,117-BENGALURU,080003-Don Bosco Academy,15,59,59,0,51,8,100,86.44
1096,102-PUNE,280006-Dr. Sakha Ram Gude High School,11,59,59,0,48,11,100,81.36
1097,103-KOLKATA,230008-Govt. Senior Secondary School,11,59,58,1,39,19,98.31,66.1
1098,107-DELHI,270535-Little Star Convent School,14,59,2,57,2,0,3.39,3.39
1099,110-PATNA,030265-Shersahsuri Ucch Madhyamik,16,59,59,0,16,43,100,27.12
1100,120-RANCHI,260121-Rajkiya Krit +2 High School,13,59,0,59,0,0,0,0
1101,101-HYDERABAD,470072-I.s.o. Jr. College,14,58,58,0,58,0,100,100
1102,118-GANDHINAGAR,040105-Shree Swaminarayan English Medium School,13,58,58,0,23,35,100,39.66
1103,109-JAIPUR,"170253-Kendriya  Vidyalaya No.3,",13,58,55,3,55,0,94.83,94.83
1104,117-BENGALURU,080079-M.V.J International School,15,58,57,1,45,12,98.28,77.59
1105,105-CHANDIGARH,050566-KOYAL PUBLIC SR. SEC. SCHOOL,15,58,58,0,57,1,100,98.28
1106,106-KOCHI,350001-Kendriya Vidyalaya,11,57,57,0,55,2,100,96.49
1107,102-PUNE,M11132-Kaiser College of Commerce,12,57,57,0,53,4,100,92.98
1108,118-GANDHINAGAR,040017-Gracious English School,12,57,57,0,57,0,100,100
1109,103-KOLKATA,230001-Govt. Model Sr. Sec. School,13,57,56,1,0,56,98.25,0
1110,119-RAIPUR,290172-J R DANI GOVT. GR HR. SEC SCHOOL,13,57,56,1,30,26,98.25,52.63
1111,114-DEHRADUN,M34238-Shri Guru Nanak Academy,12,57,57,0,28,29,100,49.12
1112,114-DEHRADUN,"450104-Vaani School And Research Centre,",14,57,57,0,57,0,100,100
1113,125-JAMMU,070039-Jawahar Navodaya Vidyalaya,12,57,57,0,31,26,100,54.39
1114,111-ALLAHABAD/PRAYAGRAJ,210723-Army Public School,14,57,54,3,44,10,94.74,77.19
1115,114-DEHRADUN,210121-Islamia Inter College,14,57,57,0,57,0,100,100
1116,109-JAIPUR,320609-HQ 24 Rapid,12,57,56,1,52,4,98.25,91.23
1117,111-ALLAHABAD/PRAYAGRAJ,210158-St.andrews High School,12,57,57,0,56,1,100,98.25
1118,114-DEHRADUN,340193-U.s.r. Indu Inter College,10,57,57,0,17,40,100,29.82
1119,107-DELHI,270202-Shiksha Bharti Public School,12,56,0,56,0,0,0,0
1120,106-KOCHI,090069-Jawahar Navodaya Vidyalaya,11,56,56,0,54,2,100,96.43
1121,105-CHANDIGARH,160074-Aadharshila The Foundation,14,56,56,0,17,39,100,30.36
1122,104-GUWAHATI,020026-Kendriya Vidyalaya,13,56,56,0,54,2,100,96.43
1123,105-CHANDIGARH,050613-Sardar Vallabh Bhai Public School,13,56,56,0,56,0,100,100
1124,109-JAIPUR,170275-Supreme Bal Bharti Sr.sec.school,12,56,56,0,55,1,100,98.21
1125,111-ALLAHABAD/PRAYAGRAJ,M38273-National Public Inter College,12,56,30,26,26,4,53.57,46.43
1126,117-BENGALURU,080076-Delhi Public School,13,56,56,0,56,0,100,100
1127,109-JAIPUR,170002-New Look Central School,12,56,54,2,54,0,96.43,96.43
1128,104-GUWAHATI,"020047-Kendriya Vidyalaya, Crpf,",13,55,55,0,52,3,100,94.55
1129,111-ALLAHABAD/PRAYAGRAJ,210030-Kendriya Vidyalaya No.1 AFS Chakeri Kanpur,14,55,54,1,40,14,98.18,72.73
1130,114-DEHRADUN,340111-Govt. Intermediate College,13,55,55,0,15,40,100,27.27
1131,107-DELHI,270464-M.d. Memorial Sec. Public School,11,55,53,2,53,0,96.36,96.36
1132,114-DEHRADUN,340031-Kendriya Vidyalaya No.1,12,55,55,0,16,39,100,29.09
1133,113-BHOPAL,100080-Adarsh Higher Sec.school,11,55,0,55,0,0,0,0
1134,114-DEHRADUN,340177-Tharu Govt. Inter College,13,55,55,0,50,5,100,90.91
1135,120-RANCHI,260198-Saraswati Vidya Mandir,11,55,0,55,0,0,0,0
1136,118-GANDHINAGAR,040048-Adarsh Vidhyalay,12,55,55,0,47,8,100,85.45
1137,106-KOCHI,M40059-Islamic Central School,12,55,55,0,51,4,100,92.73
1138,111-ALLAHABAD/PRAYAGRAJ,210668-Identity Educational Academy,13,55,55,0,51,4,100,92.73
1139,107-DELHI,210509-New Adarsh Public School,12,54,0,54,0,0,0,0
1140,105-CHANDIGARH,160027-Shining Stars Senior Sec. School,12,54,54,0,54,0,100,100
1141,120-RANCHI,260192-Kerala Samajam Model School,11,54,54,0,37,17,100,68.52
1142,109-JAIPUR,170386-AVS School,13,54,51,3,51,0,94.44,94.44
1143,102-PUNE,110133-The Chanda Devi Saraf School,11,54,54,0,49,5,100,90.74
1144,102-PUNE,110055-Divine Provident High School & Jr. College,12,54,54,0,54,0,100,100
1145,107-DELHI,210383-Mahaveer Singh Inter College,13,54,32,22,32,0,59.26,59.26
1146,107-DELHI,270512-Jagriti Public School,13,54,0,54,0,0,0,0
1147,120-RANCHI,260122-J.b.c. +2 School,10,54,0,54,0,0,0,0
1148,114-DEHRADUN,M38344-Madarsa Maulana Abul Kalam Azad,15,54,54,0,54,0,100,100
1149,114-DEHRADUN,340252-Divine Light School,12,54,53,1,29,24,98.15,53.7
1150,114-DEHRADUN,210317-St. Francis School,10,53,53,0,53,0,100,100
1151,125-JAMMU,070032-Jawahar Navodaya Vidyalaya,11,53,53,0,53,0,100,100
1152,114-DEHRADUN,340203-Government Inter College,13,53,53,0,53,0,100,100
1153,123-GANGTOK,220055-Auxilium Convent,10,53,52,1,52,0,98.11,98.11
1154,123-GANGTOK,180011-Govt. Senior Secondary School,12,53,53,0,50,3,100,94.34
1155,107-DELHI,M38365-New Horizon School,11,53,53,0,44,9,100,83.02
1156,114-DEHRADUN,M38216-Islamia Inter Collere,14,53,53,0,53,0,100,100
1157,120-RANCHI,260052-Rabindra Nath Tagore Inter College,12,53,53,0,53,0,100,100
1158,118-GANDHINAGAR,390129-P. Chandra International School,11,53,53,0,39,14,100,73.58
1159,103-KOLKATA,460520-Khanyadihi High School,12,53,53,0,50,3,100,94.34
1160,114-DEHRADUN,340285-Gandhi Inter College,14,52,52,0,52,0,100,100
1161,122-DHARAMSALA,060022-St. Luke's High School,12,52,0,52,0,0,0,0
1162,120-RANCHI,260095-Govt. Russel +2 High School,12,52,0,52,0,0,0,0
1163,107-DELHI,270177-Gagan Bharti Public School,12,52,47,5,43,4,90.38,82.69
1164,123-GANGTOK,180010-Govt. Senior Secondary School,12,52,19,33,0,19,36.54,0
1165,111-ALLAHABAD/PRAYAGRAJ,210775-Smart Indian Model School,13,52,49,3,39,10,94.23,75
1166,102-PUNE,110044-Jai Bharat High School& Jr.college,10,52,52,0,49,3,100,94.23
1167,107-DELHI,210761-NARAYANA PUBLIC SCHOOL,11,52,51,1,13,38,98.08,25
1168,109-JAIPUR,170313-Nav Nirman Bal Niketan Sec.school,13,51,51,0,51,0,100,100
1169,121-CHENNAI,190108-Mahatma Montessori School,18,51,46,5,46,0,90.2,90.2
1170,105-CHANDIGARH,050574-INDOLOGY PUBLIC SR. SEC. SCHOOL,11,51,49,2,32,17,96.08,62.75
1171,113-BHOPAL,100008-Kendriya Vidyalaya No.1,13,51,0,51,0,0,0,0
1172,114-DEHRADUN,M38250-Jamia Tut Tayyibat Niswan College,11,51,44,7,14,30,86.27,27.45
1173,107-DELHI,270292-T.N.Public School,12,51,49,2,49,0,96.08,96.08
1174,107-DELHI,050122-M.D. High School,11,51,50,1,50,0,98.04,98.04
1175,109-JAIPUR,M17074-Baba Har Singh Bedi Memorial,11,51,48,3,48,0,94.12,94.12
1176,105-CHANDIGARH,"050259-Vidya Bharti Sr.sec.school,",12,51,51,0,50,1,100,98.04
1177,109-JAIPUR,170303-Sethi Sr.sec.school,13,51,49,2,49,0,96.08,96.08
1178,107-DELHI,270522-Shri Tula Ram Public School,10,51,0,51,0,0,0,0
1179,118-GANDHINAGAR,040076-Shree V M Chandera Secondary and Higher Sec. School,10,51,51,0,41,10,100,80.39
1180,121-CHENNAI,190111-The Trinity Academy,10,50,12,38,12,0,24,24
1181,104-GUWAHATI,029001-Model Study Centre,13,50,50,0,44,6,100,88
1182,106-KOCHI,M40072-Al Ameen English School,11,50,50,0,49,1,100,98
1183,115-BHUBANESWAR,410134-410134-BARRKS HIGH SCHOOL,16,50,48,2,38,10,96,76
1184,104-GUWAHATI,020028-Kendriya Vidyalaya,11,50,50,0,42,8,100,84
1185,114-DEHRADUN,340187-Jawahar Navodaya Vidyalaya,12,50,50,0,21,29,100,42
1186,117-BENGALURU,M08026-Bethany High School,13,50,50,0,46,4,100,92
1187,109-JAIPUR,170383-New Rajasthan Public Sr.Sec.School,10,50,50,0,50,0,100,100
1188,114-DEHRADUN,210175-Dayanand Saraswati Inter College,13,50,50,0,20,30,100,40
1189,106-KOCHI,M40065-Iqra Islamic Women's College,11,50,50,0,50,0,100,100
1190,107-DELHI,210772-Bloom International School,11,50,40,10,4,36,80,8
1191,118-GANDHINAGAR,040005-Queen Of Angels Convent School,10,50,50,0,33,17,100,66
1192,107-DELHI,270549-D K Convent School,11,50,50,0,37,13,100,74
1193,117-BENGALURU,080031-Kendriya Vidyalaya,13,50,50,0,34,16,100,68
1194,118-GANDHINAGAR,040064-Navrachana school,16,50,50,0,36,14,100,72
1195,114-DEHRADUN,340195-Govt. Inter College,13,50,50,0,13,37,100,26
1196,115-BHUBANESWAR,M15042-Syed Saminary High School,9,50,50,0,46,4,100,92
1197,107-DELHI,270432-Delhi Convent School,10,49,48,1,39,9,97.96,79.59
1198,105-CHANDIGARH,160049-Tagore Public School,12,49,48,1,45,3,97.96,91.84
1199,111-ALLAHABAD/PRAYAGRAJ,210132-Zakir Hussain Model Sr.sec.school,11,49,48,1,31,17,97.96,63.27
1200,111-ALLAHABAD/PRAYAGRAJ,210730-Kendriya Vidyalaya No.2,15,49,42,7,42,0,85.71,85.71
1201,114-DEHRADUN,M34237-Madarsa Garib Nawaz,10,49,49,0,49,0,100,100
1202,105-CHANDIGARH,160069-K.K.MAHAJAN A.V.M. Sr.Sec SCHOOL,10,49,45,4,42,3,91.84,85.71
1203,106-KOCHI,400042-Kendriya Vidyalaya,10,49,49,0,47,2,100,95.92
1204,106-KOCHI,090093-Rani Public School,11,48,48,0,48,0,100,100
1205,118-GANDHINAGAR,390113-Nand Vidya Niketan,12,48,48,0,37,11,100,77.08
1206,122-DHARAMSALA,060023-Akal Academy,12,48,3,45,2,1,6.25,4.17
1207,102-PUNE,"M11086-Lady Khatun Marium School,",9,48,46,2,40,6,95.83,83.33
1208,102-PUNE,110033-Shoeb High School & Jr.college,10,48,48,0,48,0,100,100
1209,109-JAIPUR,170237-Kiran Bal Bharti Sr.sec. School,10,48,37,11,36,1,77.08,75
1210,111-ALLAHABAD/PRAYAGRAJ,210313-Lord Mahakaleshwar Inter College,10,48,48,0,48,0,100,100
1211,104-GUWAHATI,120046-The Little Angel's English School,12,48,48,0,47,1,100,97.92
1212,104-GUWAHATI,300017-Govt. Khawzawl High School,12,48,48,0,48,0,100,100
1213,113-BHOPAL,J10208-District Jail,8,48,48,0,48,0,100,100
1214,117-BENGALURU,M08059-SERA JE SECONDARY SCHOOL,9,48,48,0,48,0,100,100
1215,120-RANCHI,260044-Dav Public School,10,48,48,0,48,0,100,100
1216,104-GUWAHATI,020051-Jawahar Navodaya Vidyalaya,10,48,48,0,41,7,100,85.42
1217,107-DELHI,210801-Paras Public School,10,47,0,47,0,0,0,0
1218,109-JAIPUR,170134-Sanskar Shikshan Sansthan,10,47,47,0,47,0,100,100
1219,105-CHANDIGARH,050438-S.D. Senior Secondary School,12,47,47,0,31,16,100,65.96
1220,121-CHENNAI,190041-Riverside Public School,15,47,0,47,0,0,0,0
1221,120-RANCHI,260188-Jasidih Public School,11,47,0,47,0,0,0,0
1222,105-CHANDIGARH,050150-Arya Sr. Sec. School,11,47,47,0,11,36,100,23.4
1223,104-GUWAHATI,200021-Chandraipara H.s.school,10,47,46,1,41,5,97.87,87.23
1224,103-KOLKATA,460526-Durgapur Iswar Chandra Vidyasagar (DICV) Public School,10,47,47,0,21,26,100,44.68
1225,104-GUWAHATI,020037-Kendriya Vidyalaya,13,47,47,0,46,1,100,97.87
1226,109-JAIPUR,170291-Shri Ram Public Sr. Sec. School,10,47,47,0,47,0,100,100
1227,109-JAIPUR,320612-HRDC HQ 16 INF Div,14,47,43,4,27,16,91.49,57.45
1228,117-BENGALURU,M08058-SILICON CITY PUBLIC SCHOOL,11,47,47,0,43,4,100,91.49
1229,120-RANCHI,M26082-Loyala School,11,47,47,0,47,0,100,100
1230,110-PATNA,030263-+2 Zila School,12,47,47,0,16,31,100,34.04
1231,107-DELHI,270404-Shanti Gyan International,9,47,0,47,0,0,0,0
1232,114-DEHRADUN,M21647-Madrasa Jamiatus Salihat Girls,9,47,47,0,46,1,100,97.87
1233,105-CHANDIGARH,160170-New Model Sr. Sec. School,12,46,45,1,31,14,97.83,67.39
1234,105-CHANDIGARH,250015-THE BRITISH SCHOOL,10,46,46,0,25,21,100,54.35
1235,121-CHENNAI,190081-Govt. Hr. Sec. School,11,46,42,4,22,20,91.3,47.83
1236,104-GUWAHATI,020008-Carmel Trng. Cen.of Donbosco School,9,46,46,0,46,0,100,100
1237,105-CHANDIGARH,"160071-B.c.m.arya Model Sr.sec.school,",12,46,45,1,33,12,97.83,71.74
1238,117-BENGALURU,080078-BGS National Public School,11,46,46,0,32,14,100,69.57
1239,111-ALLAHABAD/PRAYAGRAJ,210043-Allahabad Gram Vikas Samiti,12,46,45,1,35,10,97.83,76.09
1240,105-CHANDIGARH,M38014-Ilyas Public School,11,46,46,0,46,0,100,100
1241,118-GANDHINAGAR,390075-K.r. Doshi High School,10,45,45,0,45,0,100,100
1242,107-DELHI,210035-Kendriya Vidyalaya No.1,12,45,0,45,0,0,0,0
1243,109-JAIPUR,170425-Shaheed Kansingh Memorial Shikshan Sansthan Senior Secondary School,9,45,45,0,45,0,100,100
1244,109-JAIPUR,170082-Lal Bahadur Shastri Sr.sec School,8,45,45,0,45,0,100,100
1245,114-DEHRADUN,340105-Govt. Inter College,9,45,45,0,9,36,100,20
1246,102-PUNE,"M38037-Shoeb High School & Jr College,",9,45,45,0,45,0,100,100
1247,104-GUWAHATI,020057-Kendriya Vidyalaya,9,45,45,0,44,1,100,97.78
1248,120-RANCHI,260108-S.s. +2 High School,10,45,0,45,0,0,0,0
1249,104-GUWAHATI,M38331-Maryam Ajmal Women's College Of,9,45,27,18,0,27,60,0
1250,107-DELHI,270347-Shishu Niketan Public School,9,45,40,5,17,23,88.89,37.78
1251,121-CHENNAI,M42001-Kh Matriculation Boys Hr.sec.school,10,45,40,5,38,2,88.89,84.44
1252,109-JAIPUR,170417-Adarsh Bal Niketan Sr. Sec. School,9,45,45,0,45,0,100,100
1253,103-KOLKATA,M38140-Belgachia Urdu High School,11,45,45,0,0,45,100,0
1254,111-ALLAHABAD/PRAYAGRAJ,210513-Maya Devi Higher Secondary School,8,44,44,0,44,0,100,100
1255,122-DHARAMSALA,060062-Govt.sr.sec.school,10,44,0,44,0,0,0,0
1256,113-BHOPAL,100044-Raghuvansh Higher Sec. School,11,44,39,5,0,39,88.64,0
1257,114-DEHRADUN,340324-Persistent Students Nest Higher Secondary School,10,44,44,0,42,2,100,95.45
1258,105-CHANDIGARH,M16105-Almighty Public School,11,44,44,0,35,9,100,79.55
1259,107-DELHI,210366-Kendriya Vidyalaya,9,44,0,44,0,0,0,0
1260,121-CHENNAI,190098-Sri Seshaas Public School,15,44,41,3,41,0,93.18,93.18
1261,109-JAIPUR,170137-A.n. Public School,10,44,40,4,40,0,90.91,90.91
1262,110-PATNA,030073-Rashtiya Ucch Vidyalaya,10,43,43,0,37,6,100,86.05
1263,111-ALLAHABAD/PRAYAGRAJ,M21196-Amiruddaula Islamia Inter College,11,43,40,3,34,6,93.02,79.07
1264,113-BHOPAL,M38346-Madarsa Nascent Diniyat,7,43,43,0,43,0,100,100
1265,107-DELHI,270518-Vasundhara Public School,11,43,43,0,43,0,100,100
1266,113-BHOPAL,100302-Siddhi Vinayak Public School,7,43,43,0,43,0,100,100
1267,107-DELHI,210650-Bhagirath Public School,9,43,0,43,0,0,0,0
1268,114-DEHRADUN,340185-Will Field School,12,43,43,0,43,0,100,100
1269,111-ALLAHABAD/PRAYAGRAJ,210783-Jim Corbett Public School,9,43,42,1,32,10,97.67,74.42
1270,121-CHENNAI,190062-Govt. Boys Higher Secondary School,12,43,0,43,0,0,0,0
1271,114-DEHRADUN,340200-Govt. Inter College,12,43,42,1,12,30,97.67,27.91
1272,107-DELHI,270504-Yuvashakti Model School,11,43,40,3,40,0,93.02,93.02
1273,109-JAIPUR,170395-Swami Shree Niwas Acharya Shikshan,9,43,43,0,43,0,100,100
1274,117-BENGALURU,M08060-Orchids The International School,9,43,43,0,30,13,100,69.77
1275,102-PUNE,110141-Sree Narayana Guru College of Commerce,8,43,40,3,38,2,93.02,88.37
1276,118-GANDHINAGAR,040045-Saraswat International Academy,9,43,43,0,28,15,100,65.12
1277,114-DEHRADUN,340170-Rashtriya Inter College,8,43,43,0,14,29,100,32.56
1278,110-PATNA,030150-Rajkiyakrit Rajput Ucch Vidyalaya,9,43,43,0,13,30,100,30.23
1279,103-KOLKATA,220113-Devaki Memorial School,10,43,43,0,43,0,100,100
1280,109-JAIPUR,170240-Govind Vidya Mandir Hr.sec. School,12,42,42,0,42,0,100,100
1281,110-PATNA,J03014-District Jail,8,42,42,0,42,0,100,100
1282,103-KOLKATA,M22099-Asansol St.Anthony Secondary School,7,42,42,0,1,41,100,2.38
1283,102-PUNE,110148-Indira National School,11,42,42,0,41,1,100,97.62
1284,117-BENGALURU,M38164-Daffodils High School,8,42,42,0,42,0,100,100
1285,106-KOCHI,M40035-Darul Hikam Residential School,9,42,42,0,41,1,100,97.62
1286,111-ALLAHABAD/PRAYAGRAJ,210138-Ajay Girls Inter College,11,42,42,0,34,8,100,80.95
1287,105-CHANDIGARH,050066-Dharamvati Public Sr. Sec. School,10,42,42,0,15,27,100,35.71
1288,118-GANDHINAGAR,390157-Chavda S J And Shah S B High School,7,42,42,0,42,0,100,100
1289,103-KOLKATA,M22095-Abbot Shishu Hall,8,42,42,0,0,42,100,0
1290,120-RANCHI,260125-Rajkiyakrit  +2 High School,10,42,11,31,5,6,26.19,11.9
1291,111-ALLAHABAD/PRAYAGRAJ,210324-Maharishi Arvind Shikshan Sansthan,8,42,42,0,35,7,100,83.33
1292,125-JAMMU,M07049-Muslim Institute Of Education,9,42,42,0,20,22,100,47.62
1293,114-DEHRADUN,340271-Govt. Inter College,8,42,42,0,24,18,100,57.14
1294,113-BHOPAL,M10174-Madarsa Firdos Hr.sec.study Center,7,41,0,41,0,0,0,0
1295,115-BHUBANESWAR,J15159-District Jail,10,41,32,9,23,9,78.05,56.1
1296,111-ALLAHABAD/PRAYAGRAJ,210789-Vikas Bharti School,10,41,41,0,32,9,100,78.05
1297,110-PATNA,"030314-Sitamarhi Inter +2 College,",8,41,41,0,11,30,100,26.83
1298,107-DELHI,050359-Ch. Chain Sukh Sr.sec. School,8,41,0,41,0,0,0,0
1299,106-KOCHI,M40071-Gods Own Public School,8,41,41,0,41,0,100,100
1300,107-DELHI,M27479-Khadijatul Kubra Girls Public Sch.,11,41,41,0,41,0,100,100
1301,105-CHANDIGARH,050356-V.B.N. Senior Secondary School,9,41,41,0,30,11,100,73.17
1302,104-GUWAHATI,"240005-Govt. Hr.sec. School,",9,41,41,0,40,1,100,97.56
1303,121-CHENNAI,M42004-Saudia Oriental Arabic Hr. Sec. School,10,41,41,0,41,0,100,100
1304,110-PATNA,030335-Rajkiya Inter +2 School,8,41,41,0,20,21,100,48.78
1305,105-CHANDIGARH,050506-Aryans Model Sr. Sec. School,9,41,41,0,41,0,100,100
1306,105-CHANDIGARH,050094-Gaur Brahman Vidya Parcharini Sabha,9,41,40,1,21,19,97.56,51.22
1307,111-ALLAHABAD/PRAYAGRAJ,210596-M.G. Convent School,12,41,36,5,30,6,87.8,73.17
1308,114-DEHRADUN,340205-Govt. Pratap Inter College,11,40,40,0,12,28,100,30
1309,117-BENGALURU,450058-Spastic Society Of Karnataka,11,40,40,0,40,0,100,100
1310,106-KOCHI,400050-Kendriya Vidyalaya,8,40,40,0,38,2,100,95
1311,118-GANDHINAGAR,390158-Rasiklal Nathulal Shah (Rangwala) Secondary & Higher Secondary School,8,40,40,0,36,4,100,90
1312,107-DELHI,270474-Indian Convent School,7,40,40,0,40,0,100,100
1313,105-CHANDIGARH,050585-KVM PUBLIC SCHOOL,8,40,40,0,18,22,100,45
1314,109-JAIPUR,170249-Adarsh Ucch Madhyamik Bal Vidyalaya,9,40,37,3,37,0,92.5,92.5
1315,109-JAIPUR,170389-Floradale Public School,9,40,33,7,28,5,82.5,70
1316,111-ALLAHABAD/PRAYAGRAJ,210189-Sant Ramkrishan Kanya Intercollege,10,39,37,2,32,5,94.87,82.05
1317,120-RANCHI,450032-Manthan Yuva Sangathan,8,39,31,8,31,0,79.49,79.49
1318,114-DEHRADUN,340250-Bhagirathi Vidyalaya,8,39,39,0,39,0,100,100
1319,106-KOCHI,400040-Kendriya Vidyalaya No-2,8,39,39,0,36,3,100,92.31
1320,111-ALLAHABAD/PRAYAGRAJ,210741-Florets International School,8,39,36,3,29,7,92.31,74.36
1321,109-JAIPUR,170230-Sh. Ram Karan Joshi Govt. Hr. Sec.,9,39,39,0,39,0,100,100
1322,104-GUWAHATI,440009-Sree Narasinghasthan High School,8,39,39,0,34,5,100,87.18
1323,107-DELHI,210233-National Public Sr.sec.school,9,39,0,39,0,0,0,0
1324,103-KOLKATA,220120-AGPN Convent & E.R. School,8,39,39,0,0,39,100,0
1325,121-CHENNAI,M19042-Montfort Matric Hr.sec. School,18,39,38,1,24,14,97.44,61.54
1326,111-ALLAHABAD/PRAYAGRAJ,210044-Aminabad Inter College,14,39,29,10,21,8,74.36,53.85
1327,102-PUNE,110006-St.joseph's Convent Girls H.school,17,39,39,0,35,4,100,89.74
1328,114-DEHRADUN,340128-Govt. Inter College,9,38,38,0,10,28,100,26.32
1329,102-PUNE,M11078-St. Ursula High School,9,38,38,0,38,0,100,100
1330,107-DELHI,270208-Govt. Sarvodaya Bal Vidyalaya,9,38,0,38,0,0,0,0
1331,105-CHANDIGARH,050588-B.V.N. Sr. Sec. School,8,38,38,0,22,16,100,57.89
1332,113-BHOPAL,"100075-Vikram Higher Secondary School,",10,38,4,34,0,4,10.53,0
1333,121-CHENNAI,190126-R.D. International School,7,38,38,0,35,3,100,92.11
1334,110-PATNA,M03362-Sadar Alam Memorial Sr.sec.school,8,38,38,0,38,0,100,100
1335,105-CHANDIGARH,160013-D.r.modern Sr. Sec.school,8,38,37,1,14,23,97.37,36.84
1336,108-ABROAD/NIOS HQ,940001-LAURELS EDUCATION SERVICES WILL,8,38,0,38,0,0,0,0
1337,115-BHUBANESWAR,150036-150036-Jawahar Navodaya Vidyalaya,9,37,30,7,19,11,81.08,51.35
1338,107-DELHI,270397-Govt. Boys Senior Secondary School,10,37,19,18,18,1,51.35,48.65
1339,104-GUWAHATI,440010-Don Bosco High School,8,37,37,0,35,2,100,94.59
1340,123-GANGTOK,460531-North Bengal Central School,9,37,37,0,37,0,100,100
1341,121-CHENNAI,190035-Kendriya Vidyalaya No-2,8,37,1,36,0,1,2.7,0
1342,111-ALLAHABAD/PRAYAGRAJ,210598-T.c. Chandra Inter College,7,37,37,0,37,0,100,100
1343,113-BHOPAL,100183-Maa Sharda Higher Secondary School,7,37,0,37,0,0,0,0
1344,121-CHENNAI,M38322-Crescent Matric Hr.sec. School,9,37,37,0,37,0,100,100
1345,104-GUWAHATI,140022-Kendriya Vidyalaya,8,37,37,0,36,1,100,97.3
1346,106-KOCHI,400067-Aliya Senior Secondary School,7,37,37,0,33,4,100,89.19
1347,111-ALLAHABAD/PRAYAGRAJ,450105-Jyoti Badhir Vidyalaya,6,36,36,0,36,0,100,100
1348,111-ALLAHABAD/PRAYAGRAJ,210556-St. Xavier's High School,10,36,36,0,36,0,100,100
1349,113-BHOPAL,J10213-District Jail,9,36,36,0,0,36,100,0
1350,106-KOCHI,400026-Shree Vivekanand Sec.school,9,36,36,0,33,3,100,91.67
1351,103-KOLKATA,220084-Balika Vidya Bhawan,8,36,36,0,0,36,100,0
1352,111-ALLAHABAD/PRAYAGRAJ,M21546-National Public Inter College,8,36,35,1,31,4,97.22,86.11
1353,111-ALLAHABAD/PRAYAGRAJ,210131-St. H.N. Public Inter College,8,36,33,3,26,7,91.67,72.22
1354,105-CHANDIGARH,160115-Anne's School,12,36,35,1,22,13,97.22,61.11
1355,102-PUNE,110124-Gokulnath Sec. & Hr.sec. School,7,36,36,0,35,1,100,97.22
1356,102-PUNE,M11096-St. Felix High School,9,36,36,0,36,0,100,100
1357,121-CHENNAI,190146-APL Global School,17,36,36,0,36,0,100,100
1358,105-CHANDIGARH,050319-Shiv Sr.sec. School,8,35,35,0,24,11,100,68.57
1359,111-ALLAHABAD/PRAYAGRAJ,"210156-Amar Public Inter College,",8,35,34,1,29,5,97.14,82.86
1360,110-PATNA,M03113-Patna Muslim High School Inter Col.,7,35,35,0,17,18,100,48.57
1361,102-PUNE,280013-Kendriya Vidyalaya No.1,7,35,35,0,24,11,100,68.57
1362,107-DELHI,M05365-Ajmat Khan Indian Public School,7,35,35,0,35,0,100,100
1363,107-DELHI,050350-Shanti Niketan Public School,8,35,22,13,21,1,62.86,60
1364,109-JAIPUR,170441-Surya Bal Shiksha Niketan Sr. Sec. School,7,35,33,2,33,0,94.29,94.29
1365,102-PUNE,110049-Shaheed Dunichand T.kalani,8,35,35,0,34,1,100,97.14
1366,114-DEHRADUN,340120-Govt. Inter College,8,35,35,0,35,0,100,100
1367,102-PUNE,110011-Holy Cross Convent High School,8,35,34,1,34,0,97.14,97.14
1368,105-CHANDIGARH,050047-Navyug Public School,7,35,35,0,35,0,100,100
1369,121-CHENNAI,190147-Vedavalli Vidyalaya,7,35,29,6,12,17,82.86,34.29
1370,107-DELHI,M27489-Jesus Grace Modern School,7,35,0,35,0,0,0,0
1371,111-ALLAHABAD/PRAYAGRAJ,210322-Purvanchal Bal Shramik Madhyasmik,8,35,35,0,35,0,100,100
1372,110-PATNA,"030348-Town High School,",8,34,34,0,15,19,100,44.12
1373,105-CHANDIGARH,050630-Shri Krishna Public School,7,34,34,0,12,22,100,35.29
1374,104-GUWAHATI,450172-SHISHU SAROTHI CENTRE FOR REHABILITATION AND TRAINING FOR MULTIPLE DISABILITIES,8,34,34,0,34,0,100,100
1375,120-RANCHI,260133-+2 Zila School,8,34,0,34,0,0,0,0
1376,111-ALLAHABAD/PRAYAGRAJ,210151-Champa Agarwal Institute Of,8,34,34,0,34,0,100,100
1377,105-CHANDIGARH,050074-Maharishi Vidya Mandir,8,34,33,1,15,18,97.06,44.12
1378,105-CHANDIGARH,050556-Guru Nanak Academy,8,34,34,0,34,0,100,100
1379,107-DELHI,210731-J. D. PUBLIC SCHOOL,7,34,27,7,0,27,79.41,0
1380,123-GANGTOK,"M22087-Good Shepherd School,",6,34,34,0,34,0,100,100
1381,118-GANDHINAGAR,040103-L D R International School,9,34,33,1,21,12,97.06,61.76
1382,109-JAIPUR,M17054-Sant Hafiz Public Sec. School,7,34,34,0,30,4,100,88.24
1383,121-CHENNAI,190152-Sri Sankara Vidyalaya Mat. Hr. Sec. School,11,34,34,0,13,21,100,38.24
1384,118-GANDHINAGAR,390156-Shri Vidhyatirth Madhyamik and Ucchatar Madhyamik Shala,6,34,34,0,27,7,100,79.41
1385,102-PUNE,M36148-Anglo Urdu Boys High School & Jr,8,34,34,0,30,4,100,88.24
1386,113-BHOPAL,100239-Alpa Bhashi Higher Secondary School,7,34,0,34,0,0,0,0
1387,118-GANDHINAGAR,040074-Smt. Sandraben Shroff Gnyan Dham School,7,33,33,0,22,11,100,66.67
1388,107-DELHI,270201-Delhi Jain Public Sr.sec. School,8,33,0,33,0,0,0,0
1389,105-CHANDIGARH,450094-National School For The Handi.sch.,9,33,33,0,26,7,100,78.79
1390,109-JAIPUR,170135-Shiv Public Sr.sec. School,8,33,30,3,30,0,90.91,90.91
1391,117-BENGALURU,080023-Swami Vivekananda Vidyashala,7,33,31,2,23,8,93.94,69.7
1392,103-KOLKATA,220123-SAINT CHRISTOPHER'S MISSION SCHOOL,6,33,33,0,0,33,100,0
1393,114-DEHRADUN,M34251-Ranikhet (mission) Inter  College,8,33,32,1,18,14,96.97,54.55
1394,125-JAMMU,"070023-Arya Kanya Vidyalaya High School,",7,33,33,0,6,27,100,18.18
1395,103-KOLKATA,220121-Army Public School,8,33,33,0,0,33,100,0
1396,107-DELHI,270442-Dhruva Public School,8,33,29,4,29,0,87.88,87.88
1397,105-CHANDIGARH,050553-B R International Public School,8,33,33,0,23,10,100,69.7
1398,109-JAIPUR,170378-Pragati Public Sr. Sec. School,6,33,33,0,33,0,100,100
1399,114-DEHRADUN,340287-Bright Inter College,8,33,32,1,17,15,96.97,51.52
1400,125-JAMMU,M07048-Greenway Public School,7,32,32,0,4,28,100,12.5
1401,102-PUNE,M11134-St. Mary's High School,7,32,32,0,31,1,100,96.88
1402,105-CHANDIGARH,050518-Aryavart High School,9,32,32,0,32,0,100,100
1403,108-ABROAD/NIOS HQ,"320511-HQ 10 Arty Bde,",8,32,0,32,0,0,0,0
1404,117-BENGALURU,T08001-National Skill Training Institute (NSTI),16,32,32,0,23,9,100,71.88
1405,102-PUNE,M11133-MAROTRAO BANSOD JUNIOR COLLEGE,5,32,32,0,29,3,100,90.63
1406,114-DEHRADUN,M21115-H.b.h.high School,10,32,32,0,28,4,100,87.5
1407,114-DEHRADUN,M21064-Guru Tegh Bahadur Public School,7,32,32,0,15,17,100,46.88
1408,110-PATNA,030085-Mahavir Inter College,6,32,32,0,8,24,100,25
1409,118-GANDHINAGAR,M04037-St. Xavier's Vidya Vihar,7,32,32,0,29,3,100,90.63
1410,114-DEHRADUN,M21424-Madarsa Islamia Talimul Quran,7,32,31,1,28,3,96.88,87.5
1411,114-DEHRADUN,340295-S.N. Memorial Public School,7,32,32,0,32,0,100,100
1412,107-DELHI,"270393-Blooming Dales Public School,",7,32,0,32,0,0,0,0
1413,105-CHANDIGARH,050552-G. R. S. Sr. Sec. School,6,32,32,0,20,12,100,62.5
1414,114-DEHRADUN,210750-S.D.P.D PUBLIC SCHOOL,6,32,32,0,10,22,100,31.25
1415,109-JAIPUR,170218-B.r. Khokhar Memorial Sr.sec.school,6,31,28,3,27,1,90.32,87.1
1416,121-CHENNAI,190122-B V M Global School,9,31,28,3,26,2,90.32,83.87
1417,117-BENGALURU,080024-Deccan International School,8,31,31,0,30,1,100,96.77
1418,115-BHUBANESWAR,150201-Times Scholars Gurukul,6,31,26,5,22,4,83.87,70.97
1419,107-DELHI,M27152-St. Xavier School,7,31,0,31,0,0,0,0
1420,109-JAIPUR,170174-Govt. Hr. Sec. School,6,31,28,3,25,3,90.32,80.65
1421,113-BHOPAL,100134-Jawahar Navodaya Vidyalaya,8,31,0,31,0,0,0,0
1422,120-RANCHI,260031-Bokaro Public School,6,31,29,2,29,0,93.55,93.55
1423,106-KOCHI,400052-Kendriya Vidyalaya,6,31,31,0,27,4,100,87.1
1424,103-KOLKATA,220031-Kendriya Vidyalaya No.1,7,31,31,0,0,31,100,0
1425,115-BHUBANESWAR,150012-Harobino Vidya Bhawan,6,31,27,4,22,5,87.1,70.97
1426,117-BENGALURU,080066-Sri Sri Ravishankar Vidya Mandir,8,31,31,0,31,0,100,100
1427,103-KOLKATA,460525-AGPN Convent & E.R. School,6,31,31,0,0,31,100,0
1428,103-KOLKATA,220105-Chakdaha Model School,6,31,31,0,0,31,100,0
1429,120-RANCHI,260197-Sarala Birla Public School,7,31,31,0,20,11,100,64.52
1430,118-GANDHINAGAR,M39063-St.mary's School,9,31,31,0,30,1,100,96.77
1431,111-ALLAHABAD/PRAYAGRAJ,210273-Aliganj Montessori School,13,31,28,3,27,1,90.32,87.1
1432,114-DEHRADUN,210048-Rab Intermediate College,7,31,31,0,10,21,100,32.26
1433,113-BHOPAL,M10095-Adivasi & Viklang Hr.sec.school,7,30,30,0,30,0,100,100
1434,109-JAIPUR,170089-Sumitra Memorial Public School,6,30,30,0,28,2,100,93.33
1435,105-CHANDIGARH,050224-Harsh Public Sr.sec.school,6,30,30,0,30,0,100,100
1436,104-GUWAHATI,M13018-Ferrando Speech and Hearing Centre,6,30,30,0,30,0,100,100
1437,121-CHENNAI,"190028-Kendriya Vidyalaya,",7,30,30,0,26,4,100,86.67
1438,111-ALLAHABAD/PRAYAGRAJ,210419-Career Convent Girls College,6,30,28,2,21,7,93.33,70
1439,118-GANDHINAGAR,390123-Jay Ambe International School,7,30,30,0,23,7,100,76.67
1440,110-PATNA,030091-Jayanand Ucch Vidyalaya,6,30,30,0,30,0,100,100
1441,105-CHANDIGARH,050591-Ideal International School,7,30,30,0,30,0,100,100
1442,109-JAIPUR,170131-Badhal Sunrise Senior Secondary,7,30,30,0,30,0,100,100
1443,103-KOLKATA,220058-Paranami Balika Vidya Mandir,5,30,26,4,0,26,86.67,0
1444,101-HYDERABAD,470005-St. Philomena High School,8,30,29,1,29,0,96.67,96.67
1445,107-DELHI,270094-Siddharth International Pub.School,8,30,0,30,0,0,0,0
1446,114-DEHRADUN,340006-Children's Sr. Academy,6,30,30,0,16,14,100,53.33
1447,110-PATNA,"030338-Madwari Inter +2 College,",7,30,30,0,10,20,100,33.33
1448,121-CHENNAI,190034-Kendriya Vidyalaya No-1,10,30,0,30,0,0,0,0
1449,109-JAIPUR,"170100-Kendriya Vidyalaya No. 2,",8,30,16,14,16,0,53.33,53.33
1450,107-DELHI,270247-Universal Public School,8,30,0,30,0,0,0,0
1451,105-CHANDIGARH,050526-Green Fields Public School,6,29,28,1,9,19,96.55,31.03
1452,121-CHENNAI,190030-Kendriya Vidyalaya,8,29,29,0,27,2,100,93.1
1453,110-PATNA,030326-Rajkiya +2 High School,7,29,29,0,15,14,100,51.72
1454,121-CHENNAI,420063-Kendriya Vidyalaya,6,29,24,5,4,20,82.76,13.79
1455,105-CHANDIGARH,050516-Galaxy International School,6,29,29,0,20,9,100,68.97
1456,104-GUWAHATI,M02067-AUXILIUM CONVENT HIGH SCHOOL,7,29,29,0,29,0,100,100
1457,109-JAIPUR,170310-Vidyagram International School,5,29,20,9,20,0,68.97,68.97
1458,121-CHENNAI,190065-P.k. Govt. Girls Hr.sec. School,6,29,29,0,16,13,100,55.17
1459,104-GUWAHATI,"020043-Kendriya Vidyalaya ONGC,",8,29,29,0,28,1,100,96.55
1460,110-PATNA,M38224-Khalikum  Nisha Sajjad Millat,6,29,29,0,2,27,100,6.9
1461,114-DEHRADUN,340262-V.m.j.s. Govt. Inter College,7,29,28,1,18,10,96.55,62.07
1462,110-PATNA,"030257-+2 Zila School,",6,29,29,0,8,21,100,27.59
1463,121-CHENNAI,190129-Manchester International School,6,29,4,25,0,4,13.79,0
1464,106-KOCHI,400022-Trinity Lyceum,6,29,29,0,29,0,100,100
1465,110-PATNA,030079-Gandhi Inter Vidyalay,7,29,29,0,13,16,100,44.83
1466,104-GUWAHATI,130030-Army Public School,6,29,29,0,29,0,100,100
1467,125-JAMMU,070009-Govt. Higher Secondary School,6,29,29,0,14,15,100,48.28
1468,121-CHENNAI,190164-Good Word Public School,8,29,29,0,29,0,100,100
1469,120-RANCHI,260138-+2 R.k. High School,6,29,26,3,14,12,89.66,48.28
1470,107-DELHI,210575-Braham Rishi Krishan Dutt Inter,7,29,0,29,0,0,0,0
1471,114-DEHRADUN,M21653-Pragati Senior Secondary School,6,29,29,0,19,10,100,65.52
1472,105-CHANDIGARH,050326-City Sr.sec.school,6,29,29,0,17,12,100,58.62
1473,113-BHOPAL,M10203-Madarsa Hazrat Bilal,6,29,29,0,3,26,100,10.34
1474,105-CHANDIGARH,160155-Mount Litera Zee School,6,29,29,0,27,2,100,93.1
1475,107-DELHI,270561-Holy World School,7,29,29,0,29,0,100,100
1476,109-JAIPUR,170402-Shanti Niketan Sr. Sec. School,6,28,27,1,27,0,96.43,96.43
1477,105-CHANDIGARH,160054-A.v.m Senior Secondary School,6,28,28,0,12,16,100,42.86
1478,108-ABROAD/NIOS HQ,320103-HQ 33 CORPS HRDC,7,28,0,28,0,0,0,0
1479,105-CHANDIGARH,050158-M.d.n.sr.sec.school,7,28,28,0,21,7,100,75
1480,103-KOLKATA,460527-Budge Budge St. Paul's Day School,6,28,28,0,0,28,100,0
1481,103-KOLKATA,230009-Govt. Model Sr.Sec. School,7,28,28,0,0,28,100,0
1482,109-JAIPUR,170020-Kendriya Vidyalaya No.1,6,28,28,0,28,0,100,100
1483,115-BHUBANESWAR,T15012-CENTURION PRIVATE ITI,14,28,28,0,28,0,100,100
1484,104-GUWAHATI,440006-Kampur Adarsha High School,6,28,28,0,27,1,100,96.43
1485,114-DEHRADUN,340259-Shantivallabh Memorial Inter Colleg,9,28,28,0,15,13,100,53.57
1486,111-ALLAHABAD/PRAYAGRAJ,210338-Bal Mitra School,6,28,27,1,20,7,96.43,71.43
1487,115-BHUBANESWAR,150183-Barrk's High School,5,28,23,5,15,8,82.14,53.57
1488,105-CHANDIGARH,050096-Shri Ram Sr. Sec. School,6,28,28,0,9,19,100,32.14
1489,105-CHANDIGARH,160162-Shakargarh DAV Sr. Sec. School,8,28,27,1,27,0,96.43,96.43
1490,114-DEHRADUN,340214-Kendriya  Vidyalaya,6,28,27,1,17,10,96.43,60.71
1491,115-BHUBANESWAR,M41083-Syed Seminary High School,6,28,27,1,24,3,96.43,85.71
1492,111-ALLAHABAD/PRAYAGRAJ,210759-MUKULARANYAM ENGLISH SCHOOL,9,28,25,3,23,2,89.29,82.14
1493,114-DEHRADUN,340288-P.S. Model Hr. Secondary School,6,28,28,0,28,0,100,100
1494,107-DELHI,270385-NEW OXFORD PUBLIC SCHOOL,6,28,0,28,0,0,0,0
1495,114-DEHRADUN,340268-GOVT. INTER COLLEGE,7,27,27,0,20,7,100,74.07
1496,109-JAIPUR,170412-N.V.N Sr. Sec School,5,27,22,5,19,3,81.48,70.37
1497,118-GANDHINAGAR,040082-S.V Public School,5,27,27,0,25,2,100,92.59
1498,105-CHANDIGARH,050639-Hare Krishna International Sr. Sec. School,6,27,27,0,12,15,100,44.44
1499,102-PUNE,M11067-St.paul's English School&jr.college,5,27,27,0,27,0,100,100
1500,107-DELHI,M38357-Victoria Public Senior Secondary School,9,27,11,16,5,6,40.74,18.52
1501,118-GANDHINAGAR,040079-P R Mukhi Sec. & Hr. Sec. School,6,27,27,0,20,7,100,74.07
1502,107-DELHI,270168-Govt. Boys Sr. Sec. School,6,27,0,27,0,0,0,0
1503,117-BENGALURU,080063-SRS Pre-University College,5,27,27,0,18,9,100,66.67
1504,118-GANDHINAGAR,040077-Genius English Medium School,8,27,27,0,20,7,100,74.07
1505,107-DELHI,270487-Army Public School,7,27,0,27,0,0,0,0
1506,104-GUWAHATI,020034-Kendriya Vidyalaya,7,27,27,0,24,3,100,88.89
1507,118-GANDHINAGAR,040033-Bright High School,7,27,27,0,12,15,100,44.44
1508,103-KOLKATA,220041-Vidyasagar Higher Secondary School,5,27,27,0,27,0,100,100
1509,105-CHANDIGARH,050166-Holy Angel High School,7,26,26,0,26,0,100,100
1510,111-ALLAHABAD/PRAYAGRAJ,M21001-Faiz-e-aam Modern Education Centre,5,26,24,2,18,6,92.31,69.23
1511,105-CHANDIGARH,160105-Saraswati Vidya Mandir Senior,5,26,26,0,19,7,100,73.08
1512,107-DELHI,450148-TAMANA SPECIAL SCHOOL,7,26,26,0,26,0,100,100
1513,115-BHUBANESWAR,150175-C.s.b. Zilla School,6,26,23,3,18,5,88.46,69.23
1514,105-CHANDIGARH,160142-S.D. Public School,6,26,26,0,17,9,100,65.38
1515,115-BHUBANESWAR,150015-S.aurobindo Integral Edu.& Res.cen.,5,26,26,0,23,3,100,88.46
1516,121-CHENNAI,190026-Swami Sivananda Vidya Samiti,9,26,26,0,23,3,100,88.46
1517,107-DELHI,270478-Jr Public School,5,26,26,0,26,0,100,100
1518,117-BENGALURU,450024-Asha Kiran Special Needs School,6,26,26,0,26,0,100,100
1519,107-DELHI,270514-RD INTERNATIONAL SCHOOL,6,26,0,26,0,0,0,0
1520,122-DHARAMSALA,060015-Govt.(b) Sr. Sec. School,6,26,21,5,1,20,80.77,3.85
1521,107-DELHI,270375-Bal Vidya Mandir Model School,6,26,26,0,26,0,100,100
1522,120-RANCHI,260199-Kids Garden Secondary School,6,26,26,0,26,0,100,100
1523,111-ALLAHABAD/PRAYAGRAJ,"210282-Shishu Vidya Peeth Inter College,",5,26,26,0,21,5,100,80.77
1524,120-RANCHI,260087-Jawahar Navodaya Vidyalaya,5,26,0,26,0,0,0,0
1525,116-VISAKHAPATNAM,010167-Kendriya Vidyalaya,7,26,23,3,23,0,88.46,88.46
1526,122-DHARAMSALA,060099-Rudra International School,5,26,26,0,0,26,100,0
1527,114-DEHRADUN,M21389-Ale Mansoob Inter College,6,26,25,1,15,10,96.15,57.69
1528,105-CHANDIGARH,050586-SKYPATH GLOBAL SCHOOL,6,26,26,0,14,12,100,53.85
1529,123-GANGTOK,220118-Little Flower School,7,26,26,0,26,0,100,100
1530,110-PATNA,"030334-+2 Li Academy,",6,26,26,0,11,15,100,42.31
1531,109-JAIPUR,170097-Kendriya Vidyalaya No-6,6,26,22,4,20,2,84.62,76.92
1532,103-KOLKATA,460518-Rajasthan Vidyapith,6,26,26,0,0,26,100,0
1533,102-PUNE,360133-Ali Yavar Jung National Institute,5,26,26,0,26,0,100,100
1534,111-ALLAHABAD/PRAYAGRAJ,M21492-Madarsa S. Islamia,6,26,26,0,26,0,100,100
1535,121-CHENNAI,190160-Hindustan International School,6,25,24,1,4,20,96,16
1536,113-BHOPAL,M38263-Deniyat Fadeha Madarsa,5,25,25,0,25,0,100,100
1537,118-GANDHINAGAR,390161-Shri V D Mayavanshi High School,5,25,25,0,21,4,100,84
1538,114-DEHRADUN,340315-S.B.N Academy,6,25,25,0,18,7,100,72
1539,114-DEHRADUN,340164-Anandale Public School,5,25,24,1,3,21,96,12
1540,104-GUWAHATI,140033-CHARITY RESIDENTIAL SCHOOL,5,25,25,0,25,0,100,100
1541,105-CHANDIGARH,J16006-Modern Central Jail,4,25,25,0,12,13,100,48
1542,103-KOLKATA,220132-Rishi Aurobindo Memorial Academy,5,25,25,0,0,25,100,0
1543,107-DELHI,050538-BALAJI PUBLIC SCHOOL,6,25,0,25,0,0,0,0
1544,118-GANDHINAGAR,040070-The New Tulip International Schools,5,25,25,0,14,11,100,56
1545,118-GANDHINAGAR,390052-St. Xavier's High School,5,25,25,0,25,0,100,100
1546,113-BHOPAL,J10005-District Jail,5,25,25,0,0,25,100,0
1547,111-ALLAHABAD/PRAYAGRAJ,210684-R.a. Inter College,5,25,25,0,20,5,100,80
1548,122-DHARAMSALA,060035-Govt. Senior Secondary School,5,25,25,0,23,2,100,92
1549,107-DELHI,270471-Chhotu Ram Public School,7,25,0,25,0,0,0,0
1550,110-PATNA,030178-Kendriya Vidyalaya,6,25,25,0,25,0,100,100
1551,110-PATNA,030057-Jawahar Navodaya Vidyalaya,5,25,25,0,7,18,100,28
1552,117-BENGALURU,080060-Air Force School,6,25,25,0,19,6,100,76
1553,111-ALLAHABAD/PRAYAGRAJ,210157-Aditya Birla Intermediate College Renukoot,6,25,25,0,19,6,100,76
1554,107-DELHI,450167-Institute Of Rehabilitation,6,25,25,0,25,0,100,100
1555,106-KOCHI,090052-Kendriya Vidyaloaya No-1,7,24,24,0,24,0,100,100
1556,121-CHENNAI,420064-Kendriya Vidyalaya No-1,10,24,0,24,0,0,0,0
1557,107-DELHI,M21200-Amity International School,6,24,8,16,0,8,33.33,0
1558,109-JAIPUR,170387-Taigor Shikshan Sansthan Sr.Sec.Sch,5,24,14,10,14,0,58.33,58.33
1559,114-DEHRADUN,340165-Adarsh Shishu Niketan Uchachattar,6,24,20,4,5,15,83.33,20.83
1560,105-CHANDIGARH,160125-Krishna College of Hr. Education,5,24,24,0,24,0,100,100
1561,105-CHANDIGARH,050391-Om Shanti Shiksha Sadan Sr.sec.sch.,4,24,24,0,17,7,100,70.83
1562,102-PUNE,110025-Pal Rajendra English High School,5,24,24,0,24,0,100,100
1563,114-DEHRADUN,340104-Govt.inter College,6,24,23,1,22,1,95.83,91.67
1564,107-DELHI,M21658-Madrasa Maulana Abdul Kalam Azad,4,24,24,0,24,0,100,100
1565,105-CHANDIGARH,050657-Adarsh Convent Sr. Sec. School,5,24,23,1,17,6,95.83,70.83
1566,107-DELHI,210612-Bal Jyoti Public School,5,24,0,24,0,0,0,0
1567,107-DELHI,050505-New Era Sr.sec. School,5,24,13,11,2,11,54.17,8.33
1568,105-CHANDIGARH,160037-Sacred Heart High School,4,24,22,2,11,11,91.67,45.83
1569,104-GUWAHATI,020067-Noonmati Public School,5,24,23,1,19,4,95.83,79.17
1570,105-CHANDIGARH,250008-Shishu Niketan Model Sr. Sec.school,7,24,23,1,12,11,95.83,50
1571,105-CHANDIGARH,050668-Sada Sukh Memorial Public School,6,24,24,0,16,8,100,66.67
1572,113-BHOPAL,100313-Shri Ravendra Singh Saraswati Hr. Sec. School,5,24,24,0,10,14,100,41.67
1573,125-JAMMU,070056-Army Public School,5,24,23,1,13,10,95.83,54.17
1574,114-DEHRADUN,210225-Red Rose High School,5,24,24,0,24,0,100,100
1575,109-JAIPUR,170217-R.k. Public Senior Secondary School,5,23,23,0,23,0,100,100
1576,111-ALLAHABAD/PRAYAGRAJ,210187-Dolly's Public Inter College,5,23,23,0,18,5,100,78.26
1577,121-CHENNAI,190067-Govt. Higher Secondary School,5,23,0,23,0,0,0,0
1578,111-ALLAHABAD/PRAYAGRAJ,210653-Samrat Ashok Inter College,4,23,23,0,23,0,100,100
1579,125-JAMMU,070050-New Naveen Model Hr.sec. School,5,23,23,0,11,12,100,47.83
1580,107-DELHI,M05439-Sun Rise Public School,5,23,23,0,12,11,100,52.17
1581,121-CHENNAI,190001-Sri.vidya Mandirsec.sch.&jr.college,5,23,4,19,0,4,17.39,0
1582,105-CHANDIGARH,050363-Sir Chhotu Ram Modern Sr.sec.school,4,23,23,0,23,0,100,100
1583,109-JAIPUR,170208-Govt. Sr.sec. School,7,23,19,4,19,0,82.61,82.61
1584,105-CHANDIGARH,160024-Shivalik Hills Sr. Sec. Public School,4,23,23,0,17,6,100,73.91
1585,111-ALLAHABAD/PRAYAGRAJ,210644-Study Hall,6,23,23,0,19,4,100,82.61
1586,109-JAIPUR,170384-Gyan Jyoti Model School,4,23,15,8,14,1,65.22,60.87
1587,121-CHENNAI,190117-The Camford International School,6,23,0,23,0,0,0,0
1588,111-ALLAHABAD/PRAYAGRAJ,210170-Savitri Devi Shanker Lal Sharma,5,23,22,1,15,7,95.65,65.22
1589,107-DELHI,210776-Bhartiyam School,5,23,0,23,0,0,0,0
1590,105-CHANDIGARH,050428-Sarvodaya Senior Secondary School,5,23,23,0,23,0,100,100
1591,114-DEHRADUN,"340159-Apollo International School,",6,23,23,0,11,12,100,47.83
1592,114-DEHRADUN,340216-Govt. Inter College,6,23,23,0,13,10,100,56.52
1593,114-DEHRADUN,M21409-Madarsa Babul Ilm,6,23,21,2,5,16,91.3,21.74
1594,117-BENGALURU,080032-Jawahar Navodaya Vidyalaya,4,23,23,0,18,5,100,78.26
1595,115-BHUBANESWAR,150184-A.j.o. High School,5,23,23,0,21,2,100,91.3
1596,105-CHANDIGARH,050055-Adarsh High School,5,23,23,0,23,0,100,100
1597,114-DEHRADUN,340309-Rajputana College,4,23,22,1,11,11,95.65,47.83
1598,111-ALLAHABAD/PRAYAGRAJ,210165-Sh. Mohanlal Adarsh Inter College,5,23,23,0,17,6,100,73.91
1599,104-GUWAHATI,020068-Icon Academy Jr. College,8,23,23,0,22,1,100,95.65
1600,118-GANDHINAGAR,390093-Navrachana School,6,23,23,0,22,1,100,95.65
1601,107-DELHI,M38077-Society For Promotion Of Education,6,23,0,23,0,0,0,0
1602,121-CHENNAI,420084-Veera Savarkar Netaji Matric.school,5,23,23,0,23,0,100,100
1603,115-BHUBANESWAR,150177-Brajamohan High School,5,23,23,0,15,8,100,65.22
1604,109-JAIPUR,170096-Kendriya Vidyalaya,5,23,17,6,17,0,73.91,73.91
1605,117-BENGALURU,480003-Delhi Public School,8,22,21,1,21,0,95.45,95.45
1606,114-DEHRADUN,340109-Govt. Intermediate College,6,22,22,0,5,17,100,22.73
1607,117-BENGALURU,080044-Kendriya Vidyalaya No. 2,5,22,22,0,22,0,100,100
1608,121-CHENNAI,190118-Pushpalata Vidya Mandir,5,22,20,2,16,4,90.91,72.73
1609,105-CHANDIGARH,160047-M. G. M. Sr. School,6,22,22,0,8,14,100,36.36
1610,107-DELHI,050605-Jhankar High School,5,22,0,22,0,0,0,0
1611,109-JAIPUR,170307-Bharti Vidhya Niketan Sr.sec.school,5,22,22,0,22,0,100,100
1612,110-PATNA,030371-Jawahar Navodaya Vidyalaya,5,22,22,0,19,3,100,86.36
1613,111-ALLAHABAD/PRAYAGRAJ,210809-Green Light Public School,5,22,22,0,15,7,100,68.18
1614,107-DELHI,270441-Glorious Public School,6,22,2,20,0,2,9.09,0
1615,106-KOCHI,M09098-Gods Own Public School,5,22,22,0,22,0,100,100
1616,125-JAMMU,070058-Army Public School,6,22,22,0,22,0,100,100
1617,125-JAMMU,070057-Army Public School,6,22,22,0,20,2,100,90.91
1618,118-GANDHINAGAR,390128-L D R International School,5,22,22,0,17,5,100,77.27
1619,121-CHENNAI,M19107-Kh Matriculation Boys Hr.sec.school,5,22,22,0,22,0,100,100
1620,121-CHENNAI,190009-Kendriya Vidyalaya,5,22,16,6,13,3,72.73,59.09
1621,102-PUNE,M11087-St.john's School,6,21,21,0,21,0,100,100
1622,109-JAIPUR,170372-J.D. International School,5,21,21,0,20,1,100,95.24
1623,104-GUWAHATI,020029-Kendriya Vidyalaya,4,21,21,0,19,2,100,90.48
1624,119-RAIPUR,290050-Jatan Devi Daga Hr.sec.school,6,21,20,1,12,8,95.24,57.14
1625,102-PUNE,110135-Kendriya Vidyalaya,4,21,21,0,17,4,100,80.95
1626,107-DELHI,210787-Delhi Public School,4,21,0,21,0,0,0,0
1627,105-CHANDIGARH,050620-G.L Public School,4,21,21,0,21,0,100,100
1628,123-GANGTOK,180012-Govt. Senior Secondary School,5,21,0,21,0,0,0,0
1629,105-CHANDIGARH,050214-Golden Sr. Sec. School,5,21,20,1,4,16,95.24,19.05
1630,107-DELHI,270413-Jeevan Public School,5,21,0,21,0,0,0,0
1631,114-DEHRADUN,M38368-F.D Islamia Inter College,5,21,2,19,2,0,9.52,9.52
1632,109-JAIPUR,170021-Kendriya Vidyalaya,5,21,20,1,16,4,95.24,76.19
1633,119-RAIPUR,290038-Uday Higher Secondary School,4,21,21,0,13,8,100,61.9
1634,114-DEHRADUN,210242-Gyan Bharti Inter College,4,21,20,1,8,12,95.24,38.1
1635,121-CHENNAI,190115-Kmc Public Senior Secondary School,6,21,21,0,20,1,100,95.24
1636,110-PATNA,030081-Anugrah Ucch Vidyalaya,4,21,21,0,16,5,100,76.19
1637,105-CHANDIGARH,050568-MAM CHAND PUBLIC SCHOOL ,4,21,21,0,20,1,100,95.24
1638,115-BHUBANESWAR,150191-Chitalo Mohavidyalaya,4,21,17,4,9,8,80.95,42.86
1639,106-KOCHI,M40060-Mcf Public School,4,21,21,0,21,0,100,100
1640,105-CHANDIGARH,160088-Deshmesh Public School,5,21,21,0,12,9,100,57.14
1641,107-DELHI,050293-B.r.m.sr.sec. School,5,21,5,16,5,0,23.81,23.81
1642,107-DELHI,050592-D V M High School,4,21,21,0,21,0,100,100
1643,121-CHENNAI,190032-Kendriya Vidyalaya,5,21,20,1,6,14,95.24,28.57
1644,109-JAIPUR,170344-M.r. Adarsh Academy Sec. School,5,21,20,1,20,0,95.24,95.24
1645,104-GUWAHATI,200014-Santirbazar H.s.school,4,21,21,0,20,1,100,95.24
1646,104-GUWAHATI,120005-D' Regina Higher Secondary School,5,21,21,0,20,1,100,95.24
1647,107-DELHI,050390-Saarthi Public Sr.sec. School,4,21,0,21,0,0,0,0
1648,107-DELHI,210676-New Sainik Public School,5,21,0,21,0,0,0,0
1649,117-BENGALURU,080059-East West Public School,4,20,20,0,17,3,100,85
1650,105-CHANDIGARH,050123-Deep Arya High School,4,20,20,0,7,13,100,35
1651,105-CHANDIGARH,M16113-SHRI GURU HARKRISHAN PUBLIC SCHOOL,4,20,19,1,15,4,95,75
1652,110-PATNA,"030259-Govt.high School,",4,20,20,0,9,11,100,45
1653,104-GUWAHATI,020061-R J Senior Secondary School,4,20,20,0,18,2,100,90
1654,104-GUWAHATI,020059-Orang Higher Secondary School,4,20,20,0,17,3,100,85
1655,109-JAIPUR,170334-Kendriya Vidya Mandir Sr.sec.school,5,20,17,3,15,2,85,75
1656,114-DEHRADUN,210484-Subhash Smarak Inter College,4,20,20,0,6,14,100,30
1657,111-ALLAHABAD/PRAYAGRAJ,210450-Vinayak Academy Inter College,4,20,19,1,13,6,95,65
1658,101-HYDERABAD,470214-Geethanjali Junior College,4,20,20,0,20,0,100,100
1659,121-CHENNAI,M42002-Crescent Matric Hr.sec. School,4,20,20,0,20,0,100,100
1660,107-DELHI,210599-J.p.s. Global Academy,4,20,0,20,0,0,0,0
1661,121-CHENNAI,190150-Primrose Schools,6,20,18,2,3,15,90,15
1662,103-KOLKATA,220079-Godwin Modern School,4,20,20,0,16,4,100,80
1663,105-CHANDIGARH,050147-Bal Bharti Sr.sec.school,4,20,20,0,13,7,100,65
1664,104-GUWAHATI,140003-Jawahar Navodaya Vidyalaya,4,20,20,0,19,1,100,95
1665,115-BHUBANESWAR,410147-Centurion University of Technology and Management,3,20,20,0,20,0,100,100
1666,121-CHENNAI,190165-SRM Public School,4,20,20,0,7,13,100,35
1667,102-PUNE,110048-Bharti Sanskrit Vidya Niketaram,6,20,20,0,20,0,100,100
1668,110-PATNA,030267-Kamala Nehru Shishu Vihar,4,20,20,0,3,17,100,15
1669,107-DELHI,270159-Govt. Sarvodaya Bal Vidyalaya No.-1,5,20,0,20,0,0,0,0
1670,105-CHANDIGARH,M16103-Guru Nanak Dev Model Sr.sec.school,4,20,13,7,8,5,65,40
1671,109-JAIPUR,T17008-Sushila Devi Pvt. ITI,10,20,20,0,20,0,100,100
1672,105-CHANDIGARH,450179-Tapan Rehabilitition Society,4,20,20,0,8,12,100,40
1673,104-GUWAHATI,"M02016-Don Bosco School, Sundempuri,",5,19,19,0,19,0,100,100
1674,103-KOLKATA,380303-Kankinara Himayatul Ghurba,4,19,19,0,9,10,100,47.37
1675,104-GUWAHATI,020014-Maria Public Educational Trust,4,19,19,0,19,0,100,100
1676,113-BHOPAL,100307-Army Public School No.1,6,19,0,19,0,0,0,0
1677,120-RANCHI,260118-+2 S.s.d. High School,4,19,19,0,18,1,100,94.74
1678,117-BENGALURU,080055-National Centre For Excellence,6,19,19,0,13,6,100,68.42
1679,110-PATNA,030248-V.m.high School,4,19,19,0,6,13,100,31.58
1680,119-RAIPUR,290065-Jawahar Navodaya Vidyalaya,4,19,19,0,12,7,100,63.16
1681,105-CHANDIGARH,050401-Golden Public School,4,19,19,0,9,10,100,47.37
1682,102-PUNE,360042-Jath High School,4,19,19,0,16,3,100,84.21
1683,109-JAIPUR,170427-Doon Children Academy Sr. Sec. School,4,19,19,0,19,0,100,100
1684,114-DEHRADUN,340281-P.d.s.s. Inter College,4,19,18,1,16,2,94.74,84.21
1685,113-BHOPAL,100301-Govt. Koushal Vikash Kendra Academy,4,19,14,5,0,14,73.68,0
1686,110-PATNA,030373-Jawahar Navodaya Vidyalaya,4,19,19,0,8,11,100,42.11
1687,105-CHANDIGARH,050149-Saint Nischal Sr.sec.school,5,19,19,0,6,13,100,31.58
1688,107-DELHI,270353-Spring Meadows Public School,4,19,17,2,17,0,89.47,89.47
1689,120-RANCHI,260144-S.s. +2 High School,4,19,19,0,19,0,100,100
1690,109-JAIPUR,170407-JANKI DEVI MEMORIAL PUBLIC SCHOOL,4,19,19,0,17,2,100,89.47
1691,114-DEHRADUN,M38193-Madarsa Babul Ilm,4,19,15,4,4,11,78.95,21.05
1692,107-DELHI,050629-Golden Valley International School,4,19,0,19,0,0,0,0
1693,107-DELHI,050179-Adarsh Janta Sr.sec.school,4,19,0,19,0,0,0,0
1694,109-JAIPUR,170018-Kendriya Vidyalaya No. 1,4,19,12,7,10,2,63.16,52.63
1695,109-JAIPUR,V17001-SMT. MOHARI DEVI TAPARIA VED VIDYALAYA SAMITI,4,19,19,0,19,0,100,100
1696,105-CHANDIGARH,160065-St.kabir Convent School,3,19,19,0,19,0,100,100
1697,109-JAIPUR,170004-Sophia Sr.hr.sec.school,5,19,16,3,14,2,84.21,73.68
1698,107-DELHI,050584-RBSM PUBLIC SCHOOL,4,19,0,19,0,0,0,0
1699,105-CHANDIGARH,050603-M.S Saraswati Sr. sec. School,4,19,19,0,11,8,100,57.89
1700,114-DEHRADUN,210348-Tiny Tots College,5,18,18,0,18,0,100,100
1701,101-HYDERABAD,M47181-Azaan International School,6,18,18,0,18,0,100,100
1702,111-ALLAHABAD/PRAYAGRAJ,210321-Dr.s.radha Krishnan Public Inter,5,18,18,0,12,6,100,66.67
1703,105-CHANDIGARH,050548-BKN Public School,4,18,18,0,6,12,100,33.33
1704,111-ALLAHABAD/PRAYAGRAJ,210483-Jawahar Navodaya Vidyalaya,4,18,16,2,13,3,88.89,72.22
1705,119-RAIPUR,M29055-The Jain International School,4,18,18,0,13,5,100,72.22
1706,114-DEHRADUN,340265-J.b. Memorial Academy,5,18,18,0,18,0,100,100
1707,107-DELHI,270450-Aristotle Public School,4,18,0,18,0,0,0,0
1708,109-JAIPUR,170232-S.m.m. Govt. Girl's Hr.sec. School,3,18,14,4,13,1,77.78,72.22
1709,125-JAMMU,070044-Vishaw Jyoti Shishu Niketan H.s.,4,18,18,0,9,9,100,50
1710,122-DHARAMSALA,060018-Govt. Boys Sr. Sec. School,5,18,18,0,4,14,100,22.22
1711,111-ALLAHABAD/PRAYAGRAJ,210697-Chhatradhari Inter College 4473,4,18,18,0,18,0,100,100
1712,113-BHOPAL,100006-Kendriya Vidyalaya,4,18,0,18,0,0,0,0
1713,115-BHUBANESWAR,150185-Birsa Munda Vidyapitha,6,18,17,1,15,2,94.44,83.33
1714,114-DEHRADUN,340121-Govt. Inter College,4,18,18,0,18,0,100,100
1715,104-GUWAHATI,M02048-Sacred Heart School,4,18,18,0,18,0,100,100
1716,121-CHENNAI,190114-S.s.v.m. World School,5,18,0,18,0,0,0,0
1717,125-JAMMU,M07051-Sri Guru Govind Singh Public,4,18,18,0,15,3,100,83.33
1718,111-ALLAHABAD/PRAYAGRAJ,210116-Holy Faith Inter College,4,18,17,1,13,4,94.44,72.22
1719,113-BHOPAL,100172-Bal Bharti Public School,4,18,0,18,0,0,0,0
1720,110-PATNA,030250-Govt. Higher Secondary School,4,18,18,0,6,12,100,33.33
1721,109-JAIPUR,170112-Shree Rishikul Secondary School,4,17,17,0,17,0,100,100
1722,105-CHANDIGARH,050644-Green Valley International School,4,17,17,0,9,8,100,52.94
1723,113-BHOPAL,M10278-St. Joseph's Convent Senior Sec. School,3,17,17,0,14,3,100,82.35
1724,102-PUNE,110029-St.joseph Convent Girls High School,4,17,17,0,17,0,100,100
1725,110-PATNA,450082-Mukti Niketan Bhagalpur,4,17,17,0,6,11,100,35.29
1726,114-DEHRADUN,210777-Chetna Junior High School,3,17,17,0,17,0,100,100
1727,105-CHANDIGARH,050206-A.P. Garg Public School,4,17,17,0,4,13,100,23.53
1728,110-PATNA,030287-P.n.anglo Sanskrit Ucch Vidyalaya,4,17,17,0,7,10,100,41.18
1729,119-RAIPUR,290170-Dr. Milap Ram Sahu Vidhyalaya (M.R.S.V),5,17,17,0,11,6,100,64.71
1730,111-ALLAHABAD/PRAYAGRAJ,210278-Jai Devi Awasthi Inter College,3,17,17,0,12,5,100,70.59
1731,121-CHENNAI,190015-Maharishi Vidya Mandir,3,17,0,17,0,0,0,0
1732,110-PATNA,"030251-Raj High School,",4,17,17,0,17,0,100,100
1733,105-CHANDIGARH,050604-Holy Wisdom Convent,3,17,17,0,7,10,100,41.18
1734,118-GANDHINAGAR,390091-M.B. Patel Gyanjot Vidhya Vihar,4,17,17,0,13,4,100,76.47
1735,105-CHANDIGARH,050564-M.D.S PUBLIC SCHOOL,4,17,17,0,17,0,100,100
1736,106-KOCHI,090072-Panchayat H.s.s.,4,17,17,0,15,2,100,88.24
1737,104-GUWAHATI,200013-B.b.institution,5,17,17,0,17,0,100,100
1738,121-CHENNAI,190161-Sri Sankara Matriculation Hr. Sec. School,3,16,16,0,1,15,100,6.25
1739,110-PATNA,030116-Kiddy Convent High School,3,16,16,0,5,11,100,31.25
1740,103-KOLKATA,220112-Kendriya Vidyalaya,4,16,16,0,2,14,100,12.5
1741,107-DELHI,270560-Guru Angad Public School,4,16,0,16,0,0,0,0
1742,105-CHANDIGARH,050646-Army Public School,4,16,16,0,14,2,100,87.5
1743,113-BHOPAL,100019-Chattrapati Shivaji Sr.sec Public,5,16,0,16,0,0,0,0
1744,118-GANDHINAGAR,040073-GAJERA INTERNATIONAL SCHOOL,4,16,16,0,6,10,100,37.5
1745,114-DEHRADUN,210614-Gyandeep Higher Secondary School,4,16,16,0,5,11,100,31.25
1746,106-KOCHI,M40073-St. John's Public School,3,16,16,0,16,0,100,100
1747,121-CHENNAI,190159-Anugragha International School,3,16,0,16,0,0,0,0
1748,102-PUNE,110136-Kendriya Vidyalaya No.1,4,16,16,0,16,0,100,100
1749,111-ALLAHABAD/PRAYAGRAJ,210022-Jawahar Navodaya Vidyalaya,4,16,15,1,12,3,93.75,75
1750,104-GUWAHATI,"240009-Govt. Hr. Sec. School, Khonsa",4,16,16,0,16,0,100,100
1751,114-DEHRADUN,210790-Vibgyor School,4,16,16,0,5,11,100,31.25
1752,107-DELHI,050544-S.D.M PUBLIC SCHOOL ,3,16,16,0,8,8,100,50
1753,104-GUWAHATI,020062-Sreeram Academy,4,16,16,0,11,5,100,68.75
1754,120-RANCHI,260190-Star International School,5,16,16,0,15,1,100,93.75
1755,110-PATNA,030375-Jawahar Navodaya Vidyalaya,3,16,16,0,9,7,100,56.25
1756,105-CHANDIGARH,320202-HRDC Hq 2 Corps,3,16,14,2,10,4,87.5,62.5
1757,105-CHANDIGARH,050069-Nav Bharat High School,3,16,16,0,16,0,100,100
1758,110-PATNA,030313-Marwari +2 Ucchater Vidyalaya,3,16,16,0,2,14,100,12.5
1759,107-DELHI,270553-White Leaf Public School,3,16,0,16,0,0,0,0
1760,105-CHANDIGARH,160121-Dashmesh Public Sr.Sec. School,4,16,16,0,8,8,100,50
1761,115-BHUBANESWAR,T15015-Komand Private Industrial Training Institute,3,16,16,0,14,2,100,87.5
1762,110-PATNA,030413-Shanti Mission Academy,3,16,16,0,8,8,100,50
1763,118-GANDHINAGAR,040067-Delhi Public School,3,16,16,0,13,3,100,81.25
1764,103-KOLKATA,220106-Rabindranath Higher Sec. School,3,16,16,0,16,0,100,100
1765,125-JAMMU,070059-Tiny Tots Hr.Sec. School,3,16,16,0,7,9,100,43.75
1766,104-GUWAHATI,240002-Govt. Hr. Sec.school,4,16,16,0,16,0,100,100
1767,113-BHOPAL,100272-Sakshi High School,4,16,16,0,4,12,100,25
1768,118-GANDHINAGAR,040036-Shree Amrita Academy Higher,3,16,16,0,16,0,100,100
1769,102-PUNE,M11113-St. Marys Convent School Jr college,3,16,16,0,13,3,100,81.25
1770,104-GUWAHATI,440005-Sai Rns Academy,3,16,16,0,13,3,100,81.25
1771,109-JAIPUR,170376-Name 4347,3,16,7,9,7,0,43.75,43.75
1772,116-VISAKHAPATNAM,010164-Kendriya Vidyalaya No.1,4,16,15,1,15,0,93.75,93.75
1773,113-BHOPAL,100245-St. Paul Convent Hr. Sec. School,3,16,16,0,16,0,100,100
1774,114-DEHRADUN,210050-National Muslim Academy,3,16,16,0,16,0,100,100
1775,105-CHANDIGARH,160132-Delhi Public School,3,16,14,2,7,7,87.5,43.75
1776,105-CHANDIGARH,050325-Arya Sr.sec.school,3,16,16,0,11,5,100,68.75
1777,118-GANDHINAGAR,040044-Kendriya Vidyalaya,3,16,16,0,11,5,100,68.75
1778,109-JAIPUR,M45090-St. Francis Sr. Sec. School (Tanwar Shikshan Sansthan),3,16,15,1,15,0,93.75,93.75
1779,104-GUWAHATI,M13020-Auxilium Umpohliew Jingstad Secondary School,3,15,15,0,14,1,100,93.33
1780,114-DEHRADUN,340302-Govt. Inter College,4,15,15,0,15,0,100,100
1781,105-CHANDIGARH,160128-Anuvarat Public Sr.Sec. School,3,15,15,0,10,5,100,66.67
1782,105-CHANDIGARH,050562-Harkishan Memorial Public School,4,15,15,0,8,7,100,53.33
1783,113-BHOPAL,100058-Krishna Higher Sec. School,3,15,0,15,0,0,0,0
1784,107-DELHI,050257-Kitty Garden Sr.sec.school,3,15,0,15,0,0,0,0
1785,121-CHENNAI,"190086-Kendriya Vidyalaya, Hdf",3,15,0,15,0,0,0,0
1786,121-CHENNAI,M19104-Asian Christian High School,3,15,15,0,15,0,100,100
1787,115-BHUBANESWAR,150198-Kerala English Medium School,6,15,14,1,12,2,93.33,80
1788,114-DEHRADUN,210254-Divine Inter College,3,15,15,0,5,10,100,33.33
1789,121-CHENNAI,190085-Kandriya Vidyalaya,3,15,15,0,0,15,100,0
1790,110-PATNA,030012-Jawahar Navodaya Vidyalaya,4,15,15,0,6,9,100,40
1791,121-CHENNAI,190106-H.L.C. International,3,15,15,0,14,1,100,93.33
1792,117-BENGALURU,080041-Jawahar Navodaya Vidyalaya,3,15,15,0,7,8,100,46.67
1793,110-PATNA,030244-Govt. Girls Higher Secondary School,3,15,15,0,8,7,100,53.33
1794,107-DELHI,450073-Katha School Of Entrepreneurship,3,15,13,2,0,13,86.67,0
1795,106-KOCHI,400027-Vyas Vidya Peethom,4,15,15,0,15,0,100,100
1796,102-PUNE,110060-New Modern English High School,4,15,15,0,15,0,100,100
1797,103-KOLKATA,230010-Govt. Rabindra Bangla Vidyalaya,3,15,15,0,0,15,100,0
1798,121-CHENNAI,190036-Kendriya Vidyalaya,4,15,0,15,0,0,0,0
1799,105-CHANDIGARH,050508-Gitanjali Sr.Sec. School,3,15,15,0,15,0,100,100
1800,110-PATNA,030064-Zila School,3,15,15,0,6,9,100,40
1801,105-CHANDIGARH,050351-Bhagwan Parshu Ram Sr.sec. School,3,15,15,0,9,6,100,60
1802,103-KOLKATA,220026-North Point Sr Sec.school,3,15,15,0,0,15,100,0
1803,103-KOLKATA,180017-Govt. Senior Secondary School,3,15,15,0,14,1,100,93.33
1804,107-DELHI,270536-Khemo Devi Public School,3,15,0,15,0,0,0,0
1805,121-CHENNAI,190075-Govt. Girls Hr.sec. School,6,15,0,15,0,0,0,0
1806,110-PATNA,030194-G.m.s.s. Ucch Vidyalaya,3,15,15,0,10,5,100,66.67
1807,123-GANGTOK,180020-Govt. Senior Secondary School,3,15,0,15,0,0,0,0
1808,120-RANCHI,260103-+2 High School,3,15,15,0,14,1,100,93.33
1809,115-BHUBANESWAR,"150182-Zila High School, Puri, Odisha",3,15,13,2,9,4,86.67,60
1810,111-ALLAHABAD/PRAYAGRAJ,210119-Bal Vidyalaya Madhyamik School,3,15,14,1,13,1,93.33,86.67
1811,114-DEHRADUN,340140-Moravian Institute,8,15,15,0,9,6,100,60
1812,107-DELHI,270365-Govt.co-education Secondary School,4,15,0,15,0,0,0,0
1813,111-ALLAHABAD/PRAYAGRAJ,210259-Jan Kalyan Shiksha Samiti,3,15,15,0,10,5,100,66.67
1814,111-ALLAHABAD/PRAYAGRAJ,210525-Hare Krishna Public School,3,15,15,0,12,3,100,80
1815,107-DELHI,210520-NIMT B SCHOOL,4,15,0,15,0,0,0,0
1816,104-GUWAHATI,440002-Rongkut Khorsing High School,3,15,15,0,13,2,100,86.67
1817,101-HYDERABAD,470186-Kendriya Vidyalaya,4,15,1,14,0,1,6.67,0
1818,117-BENGALURU,480004-Spastic Society Of Karnataka,6,15,15,0,14,1,100,93.33
1819,106-KOCHI,400064-Raja Rajeswari Senior Sec.school,3,14,14,0,13,1,100,92.86
1820,120-RANCHI,260034-Neta Ji Subhas Public School,3,14,0,14,0,0,0,0
1821,117-BENGALURU,480002-St. Ann's High School,4,14,14,0,11,3,100,78.57
1822,107-DELHI,050615-Modern International Sr. Sec. School,3,14,0,14,0,0,0,0
1823,107-DELHI,270541-Rural Complex For Complete Education (RCCE) Public School,4,14,1,13,0,1,7.14,0
1824,121-CHENNAI,190043-Little Kingdom School,3,14,0,14,0,0,0,0
1825,121-CHENNAI,190119-Aristo Public School,4,14,14,0,8,6,100,57.14
1826,107-DELHI,270331-Shibban Modern Public Sec. School,3,14,0,14,0,0,0,0
1827,119-RAIPUR,290173-Krishna Public School,3,14,13,1,7,6,92.86,50
1828,109-JAIPUR,170296-Abhinav Senior Secondary School,2,14,12,2,12,0,85.71,85.71
1829,122-DHARAMSALA,060020-Govt. Senior Secondary School,4,14,8,6,0,8,57.14,0
1830,111-ALLAHABAD/PRAYAGRAJ,210477-Kamla Higher Secondary School,3,14,14,0,14,0,100,100
1831,118-GANDHINAGAR,390159-Glorious Public School,2,14,14,0,12,2,100,85.71
1832,113-BHOPAL,"100126-Kendriya Vidyalaya, No.2",3,14,0,14,0,0,0,0
1833,116-VISAKHAPATNAM,010172-Kendriya Vidyalaya,3,14,14,0,14,0,100,100
1834,102-PUNE,110107-Kendriya Vidyalaya,3,14,14,0,14,0,100,100
1835,111-ALLAHABAD/PRAYAGRAJ,210052-Springdale College,3,14,14,0,10,4,100,71.43
1836,110-PATNA,"030063-G.a.inter School,",3,14,14,0,4,10,100,28.57
1837,109-JAIPUR,170019-Kendriya Vidyalaya No-1,3,14,11,3,11,0,78.57,78.57
1838,104-GUWAHATI,020002-Rupnagar Vidyapeeth High School,3,14,14,0,13,1,100,92.86
1839,114-DEHRADUN,340293-RAJEEV GANDHI NAVODAYA VIDYALAYA,3,14,14,0,9,5,100,64.29
1840,113-BHOPAL,M10229-Aaps (ashaskiya The Akshya Academy),3,14,0,14,0,0,0,0
1841,109-JAIPUR,170289-Aakansha International School,3,14,14,0,14,0,100,100
1842,107-DELHI,270511-New Krishna Model Public School ,3,14,5,9,0,5,35.71,0
1843,105-CHANDIGARH,050446-Green Valley Sr. Sec. School,3,14,14,0,7,7,100,50
1844,104-GUWAHATI,130029-Army Public School,3,14,14,0,12,2,100,85.71
1845,105-CHANDIGARH,050520-Datta Public School,3,14,14,0,2,12,100,14.29
1846,121-CHENNAI,310012-K S P International Higher Secondary School,3,14,0,14,0,0,0,0
1847,105-CHANDIGARH,050236-Red Roses Public Sr. Sec. School,3,14,14,0,14,0,100,100
1848,114-DEHRADUN,210372-Kendriya Vidyalaya,4,14,14,0,5,9,100,35.71
1849,114-DEHRADUN,210806-LTR Public School,3,14,14,0,14,0,100,100
1850,125-JAMMU,070034-Jawahar Navodaya Vidyalaya,5,14,14,0,14,0,100,100
1851,110-PATNA,030043-Saraswati Vidya Mandir,3,13,13,0,6,7,100,46.15
1852,109-JAIPUR,170357-Dr. Bansi Dhar School,3,13,10,3,10,0,76.92,76.92
1853,120-RANCHI,320608-HQ 10 Corps Hrdc,3,13,0,13,0,0,0,0
1854,111-ALLAHABAD/PRAYAGRAJ,210154-D.K.Inter College,3,13,12,1,9,3,92.31,69.23
1855,110-PATNA,030377-Jawahar Navodaya Vidyalaya,3,13,13,0,3,10,100,23.08
1856,121-CHENNAI,190140-The Indian Public School,6,13,13,0,12,1,100,92.31
1857,105-CHANDIGARH,050624-Sun Rise Senior Secondary School,3,13,13,0,8,5,100,61.54
1858,103-KOLKATA,230012-Govt. Senior Secondary School,4,13,13,0,0,13,100,0
1859,119-RAIPUR,290047-Kendriya Vidyalaya,3,13,13,0,11,2,100,84.62
1860,111-ALLAHABAD/PRAYAGRAJ,210554-Study Well Public School,3,13,13,0,9,4,100,69.23
1861,111-ALLAHABAD/PRAYAGRAJ,210415-Jawahar Navodaya Vidyalaya,6,13,9,4,8,1,69.23,61.54
1862,106-KOCHI,090083-Holy Trinity School,4,13,13,0,11,2,100,84.62
1863,105-CHANDIGARH,050116-Mamta Girls Senior Secondary School,3,13,13,0,7,6,100,53.85
1864,120-RANCHI,260201-CHHOTA NAGPUR INTER COLLEGE,3,13,13,0,12,1,100,92.31
1865,101-HYDERABAD,M01195-Mannu Model School ,4,13,13,0,13,0,100,100
1866,102-PUNE,110108-Kendriya Vidyalaya,3,13,12,1,12,0,92.31,92.31
1867,110-PATNA,030083-Hit Narayan Kshatriya +2 Vidyalaya,3,13,13,0,0,13,100,0
1868,111-ALLAHABAD/PRAYAGRAJ,210056-Jawahar Navodaya Vidyalaya,4,13,13,0,5,8,100,38.46
1869,115-BHUBANESWAR,"150193-Kendriya Vidyalaya, Bhadrak",4,13,13,0,11,2,100,84.62
1870,109-JAIPUR,170362-Alpha Public Senior Sec. School,3,13,13,0,13,0,100,100
1871,109-JAIPUR,170195-Govt. Sr. Sec. School,3,13,10,3,10,0,76.92,76.92
1872,123-GANGTOK,180007-Himalayan Pharmecy Institute,3,13,13,0,13,0,100,100
1873,104-GUWAHATI,"M02042-Montfort High School, Chabua",3,13,13,0,13,0,100,100
1874,107-DELHI,450177-NOIDA Deaf Society,3,13,13,0,13,0,100,100
1875,107-DELHI,"270386-D.c.convent Secondary School,",3,13,5,8,0,5,38.46,0
1876,106-KOCHI,M40057-Mit Trust English Medium School,3,13,13,0,12,1,100,92.31
1877,105-CHANDIGARH,160031-St.soldiers Inter College,5,13,12,1,4,8,92.31,30.77
1878,101-HYDERABAD,M47185-St. PETERS EDU SCHOOL,3,13,13,0,13,0,100,100
1879,122-DHARAMSALA,060077-Jawahar Navodaya Vidyalaya,3,13,6,7,6,0,46.15,46.15
1880,121-CHENNAI,190123-Kendriya Vidyalaya,3,13,13,0,13,0,100,100
1881,118-GANDHINAGAR,040029-Kendriya Vidyalaya,4,13,13,0,13,0,100,100
1882,111-ALLAHABAD/PRAYAGRAJ,210714-Ved Prakash Pathak Public School,3,12,12,0,10,2,100,83.33
1883,110-PATNA,030262-R.d.h.+2 School,4,12,12,0,2,10,100,16.67
1884,104-GUWAHATI,130026-Ramakrishna Mission Hr.Sec. School,2,12,12,0,11,1,100,91.67
1885,102-PUNE,110034-Yashwant Vidyapeeth Karad,3,12,12,0,6,6,100,50
1886,109-JAIPUR,170111-Nehru Public Sr.sec.school,2,12,12,0,12,0,100,100
1887,118-GANDHINAGAR,040072-NAND VIDYA NIKETAN,2,12,12,0,7,5,100,58.33
1888,105-CHANDIGARH,J16007-Central Jail,3,12,12,0,11,1,100,91.67
1889,114-DEHRADUN,340106-Govt. Inter College,4,12,12,0,12,0,100,100
1890,105-CHANDIGARH,050510-Brahmi Janta Sr. Sec. School,2,12,10,2,2,8,83.33,16.67
1891,114-DEHRADUN,210570-Mother India Inter College,3,12,12,0,12,0,100,100
1892,113-BHOPAL,100007-Kendriya Vidyalaya,3,12,10,2,10,0,83.33,83.33
1893,114-DEHRADUN,210201-Rajani Public School,3,12,12,0,4,8,100,33.33
1894,105-CHANDIGARH,050535-Guru Dronacharya Public School,3,12,12,0,8,4,100,66.67
1895,122-DHARAMSALA,M06001-New Crescent Sr.sec. School,3,12,12,0,5,7,100,41.67
1896,114-DEHRADUN,340312-Uttranchal Children's Academy Senior Secondary School,3,12,12,0,7,5,100,58.33
1897,120-RANCHI,260029-Sido Kohhu High School,2,12,0,12,0,0,0,0
1898,110-PATNA,030199-B S S Conigaite +2 School,3,12,12,0,3,9,100,25
1899,118-GANDHINAGAR,040038-Government Higher Secondary School,3,12,12,0,5,7,100,41.67
1900,107-DELHI,050643-Fogaat Public Sr. Sec. School,3,12,0,12,0,0,0,0
1901,120-RANCHI,260147-+2 Govt. Girls High School,2,12,0,12,0,0,0,0
1902,117-BENGALURU,"320410-Hrdc, Hq K&k Sub Area,",2,12,12,0,9,3,100,75
1903,113-BHOPAL,100124-Kendriya Vidyalaya,3,12,0,12,0,0,0,0
1904,105-CHANDIGARH,050246-S. K. Sr. Sec School,3,12,12,0,7,5,100,58.33
1905,111-ALLAHABAD/PRAYAGRAJ,210126-Rosy School,2,12,12,0,9,3,100,75
1906,103-KOLKATA,M22094-Belur T.h. Memorial Urdu Higher,3,12,12,0,0,12,100,0
1907,101-HYDERABAD,380119-Al-Ameen Educational Society,4,12,12,0,12,0,100,100
1908,114-DEHRADUN,340273-Govt. Inter College,3,12,12,0,12,0,100,100
1909,111-ALLAHABAD/PRAYAGRAJ,210798-Radha Krishna Memorial Education Centre,3,12,12,0,9,3,100,75
1910,114-DEHRADUN,340306-Raiwal Mil Station,3,12,12,0,8,4,100,66.67
1911,110-PATNA,030192-Kajariwal Ucch Vidyalaya,3,12,12,0,4,8,100,33.33
1912,103-KOLKATA,450178-North Bengal Central School,2,12,12,0,12,0,100,100
1913,113-BHOPAL,100031-Maharishi Vidya Mandir,3,12,12,0,3,9,100,25
1914,121-CHENNAI,190113-PADMASUBRAMANIAM BALABHAVAN,3,12,12,0,12,0,100,100
1915,121-CHENNAI,190031-Kendriya Vidyalaya,3,12,9,3,9,0,75,75
1916,121-CHENNAI,190095-Kendriya Vidyalaya,2,11,0,11,0,0,0,0
1917,120-RANCHI,260119-+2 J.k. High School,2,11,0,11,0,0,0,0
1918,109-JAIPUR,170176-Swatantrata Sainani Chiranji Lal,2,11,11,0,11,0,100,100
1919,114-DEHRADUN,M38312-Rehmania Inter College,2,11,11,0,2,9,100,18.18
1920,114-DEHRADUN,340224-Govt. Junior College,2,11,11,0,7,4,100,63.64
1921,107-DELHI,050618-JCM International School,2,11,0,11,0,0,0,0
1922,110-PATNA,"030072-B.p.ucch Vidyalaya,",3,11,11,0,2,9,100,18.18
1923,111-ALLAHABAD/PRAYAGRAJ,210422-A P S Academy,3,11,11,0,9,2,100,81.82
1924,123-GANGTOK,220063-Goethal Memorial School,2,11,11,0,11,0,100,100
1925,110-PATNA,030042-Adwaita Mission High School,2,11,11,0,10,1,100,90.91
1926,102-PUNE,110118-Jawahar Navodaya Vidyalaya,2,11,11,0,11,0,100,100
1927,107-DELHI,M05446-Iqraa Public School,2,11,11,0,6,5,100,54.55
1928,111-ALLAHABAD/PRAYAGRAJ,210482-Kendriya Vidyalaya,2,11,8,3,7,1,72.73,63.64
1929,113-BHOPAL,100011-Kendriya Vidyalaya No.1,2,11,0,11,0,0,0,0
1930,107-DELHI,050614-Shaheed Amar Singh Public School,3,11,9,2,0,9,81.82,0
1931,102-PUNE,110116-Jawahar Navodaya Vidyalaya,3,11,11,0,11,0,100,100
1932,111-ALLAHABAD/PRAYAGRAJ,M21625-St. Mary's Convent Inter College,2,11,11,0,10,1,100,90.91
1933,117-BENGALURU,080010-Divya Shanti High School,3,11,11,0,8,3,100,72.73
1934,102-PUNE,110063-J B Ludhani High School & Jr Colleg,3,11,11,0,11,0,100,100
1935,114-DEHRADUN,M34239-Rehmania Inter College,2,11,11,0,7,4,100,63.64
1936,107-DELHI,M27480-Jai Hind Public School,2,11,0,11,0,0,0,0
1937,121-CHENNAI,190155-KSR Akshara Academy,3,11,0,11,0,0,0,0
1938,120-RANCHI,260112-+2 High School,2,11,0,11,0,0,0,0
1939,108-ABROAD/NIOS HQ,950024-The Indian Community School,3,11,4,7,4,0,36.36,36.36
1940,118-GANDHINAGAR,040039-Nootan Bharti Vidyalaya,2,11,11,0,6,5,100,54.55
1941,102-PUNE,110147-Army Public School,2,11,11,0,9,2,100,81.82
1942,111-ALLAHABAD/PRAYAGRAJ,210057-Kendriya Vidyalaya,2,11,10,1,8,2,90.91,72.73
1943,104-GUWAHATI,020071-Kampur Adarsha High School,3,11,11,0,9,2,100,81.82
1944,109-JAIPUR,170261-Tagore Global International School,2,11,11,0,11,0,100,100
1945,105-CHANDIGARH,M16107-Aaban Public School,3,11,11,0,11,0,100,100
1946,109-JAIPUR,170156-Govt. Sr. Sec. School,3,11,10,1,10,0,90.91,90.91
1947,107-DELHI,"270391-Raghubir Singh Modern School,",2,11,0,11,0,0,0,0
1948,111-ALLAHABAD/PRAYAGRAJ,210728-B.G.B. Braj Education Academy,2,11,11,0,9,2,100,81.82
1949,122-DHARAMSALA,060013-Govt. Sr. Sec. School,2,11,0,11,0,0,0,0
1950,107-DELHI,M21561-St. Teresa Open School,3,11,0,11,0,0,0,0
1951,120-RANCHI,260107-S.s. +2 Vidyalaya,2,11,0,11,0,0,0,0
1952,115-BHUBANESWAR,150081-Jawahar Navodaya Vidyalaya,3,11,11,0,9,2,100,81.82
1953,105-CHANDIGARH,050192-Shiv High School,2,11,11,0,2,9,100,18.18
1954,102-PUNE,110144-Fravashi International Academy,3,11,11,0,10,1,100,90.91
1955,105-CHANDIGARH,050383-Megharam Public School,2,11,11,0,2,9,100,18.18
1956,111-ALLAHABAD/PRAYAGRAJ,210721-Sacred Heart School,2,11,10,1,8,2,90.91,72.73
1957,117-BENGALURU,080062-Sri Adichundhangiri Eng.High School,4,11,11,0,10,1,100,90.91
1958,105-CHANDIGARH,050565-GLOBAL PUBLIC SCHOOL,2,11,11,0,5,6,100,45.45
1959,101-HYDERABAD,320417-Hq 54 Inf Div,2,11,10,1,10,0,90.91,90.91
1960,103-KOLKATA,220126-Ramkrishna Vedanta Ashram Vidyamandir,2,11,11,0,0,11,100,0
1961,109-JAIPUR,170403-Maharaja Public Sr. Sec. School,2,11,11,0,9,2,100,81.82
1962,121-CHENNAI,420110-DAV Boys Sr. Secondary School,2,10,10,0,0,10,100,0
1963,106-KOCHI,M40056-Noorul Huda Orphanage,2,10,10,0,9,1,100,90
1964,114-DEHRADUN,340317-Seedling School,2,10,10,0,6,4,100,60
1965,105-CHANDIGARH,160029-St. Soldier Divine Public School,2,10,9,1,2,7,90,20
1966,103-KOLKATA,M38112-Belur T.h. Memorial Urdu Higher,4,10,10,0,0,10,100,0
1967,120-RANCHI,260167-S.s.+2 High School,2,10,0,10,0,0,0,0
1968,111-ALLAHABAD/PRAYAGRAJ,210745-K.V.N. Public School,3,10,10,0,10,0,100,100
1969,107-DELHI,210673-K.C.S. Public Inter College,2,10,0,10,0,0,0,0
1970,118-GANDHINAGAR,040027-Kendriya Vidyalaya,2,10,10,0,6,4,100,60
1971,116-VISAKHAPATNAM,010207-Vani Junior College,2,10,9,1,9,0,90,90
1972,111-ALLAHABAD/PRAYAGRAJ,210713-R.R. Public School,2,10,10,0,8,2,100,80
1973,125-JAMMU,M07024-New Horizon Institute Of Secondary,2,10,10,0,0,10,100,0
1974,114-DEHRADUN,340269-Govt. Inter College,2,10,10,0,8,2,100,80
1975,115-BHUBANESWAR,410115-Centurion Public School,2,10,8,2,8,0,80,80
1976,114-DEHRADUN,340300-Govt. Inter College,2,10,10,0,6,4,100,60
1977,111-ALLAHABAD/PRAYAGRAJ,210576-Green Field Academy Sr.sec. School,2,10,10,0,8,2,100,80
1978,114-DEHRADUN,M21230-F.d Islamia Inter College,2,10,10,0,4,6,100,40
1979,116-VISAKHAPATNAM,010199-Vinayaka High School,2,10,8,2,8,0,80,80
1980,120-RANCHI,260132-N.r. Govt. +2 H/s,2,10,0,10,0,0,0,0
1981,111-ALLAHABAD/PRAYAGRAJ,210711-Baba Gurukul Academy,2,10,9,1,7,2,90,70
1982,113-BHOPAL,100305-Ambedkar Smriti Higher Sec.School,2,10,0,10,0,0,0,0
1983,107-DELHI,450108-The Ashtavakra School (school For,2,10,10,0,10,0,100,100
1984,111-ALLAHABAD/PRAYAGRAJ,210740-Cross Belly International School,2,10,10,0,8,2,100,80
1985,105-CHANDIGARH,050597-Lord Krishna Public School,2,10,9,1,5,4,90,50
1986,104-GUWAHATI,440011-Pranab Jubilee College,3,10,10,0,9,1,100,90
1987,120-RANCHI,260073-DAV Public School,3,10,10,0,8,2,100,80
1988,116-VISAKHAPATNAM,010195-Kendriya Vidyalaya,2,10,8,2,8,0,80,80
1989,109-JAIPUR,170370-Vidhya Sagar School,2,10,5,5,5,0,50,50
1990,111-ALLAHABAD/PRAYAGRAJ,320606-HQ 33 Armd Div,2,10,9,1,9,0,90,90
1991,105-CHANDIGARH,160098-Guru Teg Bahadur Public School,2,10,10,0,8,2,100,80
1992,121-CHENNAI,190064-S.l.b. Govt. Hr. Sec. School,3,10,10,0,9,1,100,90
1993,111-ALLAHABAD/PRAYAGRAJ,210058-Annie Besant School,2,10,10,0,9,1,100,90
1994,116-VISAKHAPATNAM,010182-Sri Pragathi Junior College,2,10,10,0,10,0,100,100
1995,109-JAIPUR,170022-Kendriya Vidyalaya,2,10,7,3,7,0,70,70
1996,105-CHANDIGARH,050357-Modern Senior Secondary School,2,10,10,0,1,9,100,10
1997,109-JAIPUR,170442-Shri Krishna Secondary Public School,2,10,10,0,10,0,100,100
1998,104-GUWAHATI,M13011-St.paul's Secondary School,2,10,10,0,8,2,100,80
1999,109-JAIPUR,170106-Veer Teja Siksha Samiti Sr.sec.,2,10,9,1,9,0,90,90
2000,107-DELHI,050213-Navodaya Saraswati School,2,10,10,0,10,0,100,100
2001,121-CHENNAI,420093-Adhiparasakthi Annai Illam,2,10,10,0,2,8,100,20
2002,106-KOCHI,090025-K S Abdullah English Medium School,2,10,10,0,9,1,100,90
2003,107-DELHI,050528-Swamy Dharmanand Sr.Sec. School,3,10,0,10,0,0,0,0
2004,109-JAIPUR,170292-Shiksha High School,2,10,7,3,7,0,70,70
2005,102-PUNE,110146-Army Public School,2,10,10,0,10,0,100,100
2006,105-CHANDIGARH,050462-Gian Jyoti Senior Secondary School,3,10,10,0,5,5,100,50
2007,105-CHANDIGARH,160119-Shri Guru Arjan  Dev Sr.sec. School,2,10,10,0,10,0,100,100
2008,110-PATNA,030254-K.r.k.high School,2,10,10,0,4,6,100,40
2009,119-RAIPUR,290099-Govt. Model Ramanuj Hr. Sec.school,2,10,10,0,7,3,100,70
2010,105-CHANDIGARH,050424-C.r.b.v.m.senior Secondary School,2,10,10,0,3,7,100,30
2011,101-HYDERABAD,470001-Kendriya Vidyalaya,2,10,10,0,10,0,100,100
2012,107-DELHI,270373-Kalawati Vidya Bharti Public School,2,10,10,0,10,0,100,100
2013,109-JAIPUR,450152-Pratham Education Foundation,2,10,10,0,10,0,100,100
2014,109-JAIPUR,170304-Rajasthan Public Sr.sec. School,2,10,8,2,8,0,80,80
2015,101-HYDERABAD,470211-JAIN HERITAGE A CAMBRIDGE SCHOOL ,2,10,10,0,10,0,100,100
2016,121-CHENNAI,420006-Maharishi Vidya Mandir Senior,2,10,10,0,8,2,100,80
2017,121-CHENNAI,450174-National  Institute For Empowerment with Multiple Disabilities,2,10,10,0,0,10,100,0
2018,111-ALLAHABAD/PRAYAGRAJ,"M21296-Milton Public School,",2,10,10,0,9,1,100,90
2019,109-JAIPUR,170142-Govt. Sr.sec. School,2,10,7,3,7,0,70,70
2020,103-KOLKATA,180015-Govt. Senior Secondary School,2,10,10,0,10,0,100,100
2021,110-PATNA,030252-Rajkiya Chapman Balika(10+2)school,2,10,10,0,4,6,100,40
2022,103-KOLKATA,T22003-LUTHFA PRIVATE INDUSTRIAL,3,10,10,0,0,10,100,0
2023,107-DELHI,M21367-Nm Hr.sec.school,3,10,2,8,0,2,20,0
2024,107-DELHI,270438-S.d. Saraswati Bal Mandir,2,10,0,10,0,0,0,0
2025,118-GANDHINAGAR,040035-Atul Vidyalaya,2,10,10,0,6,4,100,60
2026,105-CHANDIGARH,050498-Nav Chetna Senior Secondary School,2,10,10,0,2,8,100,20
2027,118-GANDHINAGAR,040133-Shri V D Mayavanshi High School,2,10,10,0,6,4,100,60
2028,116-VISAKHAPATNAM,450171-New Sunflower Special School,2,10,10,0,9,1,100,90
2029,109-JAIPUR,170118-Defence Public Senior Secondary,2,10,9,1,9,0,90,90
2030,114-DEHRADUN,340305-Shishu Vidya Mandir,2,10,10,0,5,5,100,50
2031,102-PUNE,450006-A.j.n.inst.of Hearing Handicapped,2,10,10,0,8,2,100,80
2032,109-JAIPUR,170434-G.S Jangid Memorial School,2,10,10,0,10,0,100,100
2033,121-CHENNAI,190124-Brilliant School,2,10,0,10,0,0,0,0
2034,121-CHENNAI,190014-Shree Vidyalaya Mat.Hr.Sec.School,2,10,0,10,0,0,0,0
2035,109-JAIPUR,170152-Govt. Sr. Sec. School,2,10,10,0,10,0,100,100
2036,123-GANGTOK,220101-Kendriya Vidyalaya,2,10,10,0,10,0,100,100
2037,118-GANDHINAGAR,040092-Shree Swaminarayan International Gunatit Vidyadham,2,10,10,0,7,3,100,70
2038,105-CHANDIGARH,050134-Dewan Bal Krishan Public School,3,10,10,0,3,7,100,30
2039,105-CHANDIGARH,050519-Gayatri Public School,2,10,10,0,3,7,100,30
2040,118-GANDHINAGAR,390076-Sardar Public School,2,10,10,0,10,0,100,100
2041,105-CHANDIGARH,050227-Cr Sr. Sec. School,2,10,10,0,2,8,100,20
2042,109-JAIPUR,170151-Govt. Sr. Sec. School,2,10,6,4,6,0,60,60
2043,105-CHANDIGARH,050043-Kamla Montessori School,2,9,9,0,5,4,100,55.56
2044,121-CHENNAI,190051-Govt. Higher Sec. School,2,9,0,9,0,0,0,0
2045,113-BHOPAL,100022-Jawahar Navodaya Vidyalaya,2,9,0,9,0,0,0,0
2046,120-RANCHI,260038-B.n.saha D.a.v. Public School,2,9,9,0,9,0,100,100
2047,109-JAIPUR,170092-Kendriya Vidyalaya,2,9,6,3,6,0,66.67,66.67
2048,105-CHANDIGARH,050600-Kite International Public School,2,9,9,0,4,5,100,44.44
2049,119-RAIPUR,290141-Govt. Higher Secondary School,2,9,9,0,8,1,100,88.89
2050,111-ALLAHABAD/PRAYAGRAJ,210656-Morning Star Children's Academy,2,9,8,1,8,0,88.89,88.89
2051,105-CHANDIGARH,050547-Rao Ramchander Memorial Public Sch.,2,9,9,0,4,5,100,44.44
2052,111-ALLAHABAD/PRAYAGRAJ,M21472-Alpsankhyak Aqsa Public Inter,2,9,9,0,8,1,100,88.89
2053,111-ALLAHABAD/PRAYAGRAJ,210071-Kendriya Vidyalaya,2,9,9,0,6,3,100,66.67
2054,116-VISAKHAPATNAM,010121-N. V. R. Junior College,2,9,6,3,6,0,66.67,66.67
2055,106-KOCHI,090089-Model Public School,2,9,9,0,9,0,100,100
2056,105-CHANDIGARH,160101-Mother India Public School,2,9,9,0,6,3,100,66.67
2057,105-CHANDIGARH,050393-St. Paul Bharti School,2,9,8,1,5,3,88.89,55.56
2058,118-GANDHINAGAR,040056-Bansidhar Vidyalaya,2,9,9,0,8,1,100,88.89
2059,114-DEHRADUN,340125-Govt. Inter College,3,9,9,0,4,5,100,44.44
2060,113-BHOPAL,M10089-Bright Star Hr.sec.school,2,9,0,9,0,0,0,0
2061,103-KOLKATA,220097-Modella Caretaker Centre & School,2,9,9,0,0,9,100,0
2062,102-PUNE,110031-Montfort Higher Sec. School,2,9,9,0,9,0,100,100
2063,114-DEHRADUN,340023-Jawahar Navodaya Vidyalaya,3,9,9,0,2,7,100,22.22
2064,121-CHENNAI,420100-Navalar Nedunchezhian Govt.Hr.Sec.School,2,9,0,9,0,0,0,0
2065,109-JAIPUR,170410-Bhagwani Devi Shikshan Sansthan,2,9,9,0,6,3,100,66.67
2066,109-JAIPUR,170264-Maharishi Dayanand Public School,2,9,4,5,4,0,44.44,44.44
2067,121-CHENNAI,190134-BVM GLOBAL BOLLINENI HILLSIDE SENIOR SECONDARY SCHOOL,2,9,9,0,5,4,100,55.56
2068,109-JAIPUR,170165-Govt. Higher Sec. School,2,9,6,3,5,1,66.67,55.56
2069,114-DEHRADUN,340018-Jawahar Navodaya Vidyalaya,2,9,9,0,2,7,100,22.22
2070,114-DEHRADUN,340184-Sateswary Devi Memorial Public School,2,9,9,0,6,3,100,66.67
2071,110-PATNA,030010-Jawahar Navodaya Vidyalaya,2,9,9,0,2,7,100,22.22
2072,105-CHANDIGARH,050269-L.c.r.t Public School,2,9,9,0,1,8,100,11.11
2073,119-RAIPUR,290171-Adwani Oerlikon Govt. H.S. School,3,9,9,0,6,3,100,66.67
2074,120-RANCHI,260089-Jawahar Navodaya Vidyalaya,2,9,0,9,0,0,0,0
2075,107-DELHI,270475-Gyan Jyoti Public School,2,9,9,0,0,9,100,0
2076,114-DEHRADUN,340275-Super Inter College,2,9,9,0,9,0,100,100
2077,109-JAIPUR,170408-Dahdimati International Sr. Sec. School,2,9,7,2,7,0,77.78,77.78
2078,104-GUWAHATI,M02075-Adarsha Vidyapith Beluguri,2,9,9,0,8,1,100,88.89
2079,105-CHANDIGARH,050656-National Sr. Sec. School,2,9,9,0,5,4,100,55.56
2080,109-JAIPUR,M17271-Al Suffah Academy Public School,2,9,9,0,9,0,100,100
2081,113-BHOPAL,M10264-Amreen Higher Secondary School,2,9,0,9,0,0,0,0
2082,107-DELHI,050594-Aakash International School,2,9,3,6,1,2,33.33,11.11
2083,121-CHENNAI,190017-Kennedy Matriculation Higher Sec,2,9,9,0,2,7,100,22.22
2084,125-JAMMU,M38320-Muslim Institute Of Education,2,9,6,3,4,2,66.67,44.44
2085,115-BHUBANESWAR,410124-Jawahar Navodaya Vidyalaya,3,9,9,0,9,0,100,100
2086,111-ALLAHABAD/PRAYAGRAJ,210159-Dr.amrit Lal Ishrat,2,9,9,0,9,0,100,100
2087,102-PUNE,M36147-St.paul's English School&jr.college,2,9,9,0,8,1,100,88.89
2088,107-DELHI,270248-Bharat National Public School,2,9,0,9,0,0,0,0
2089,105-CHANDIGARH,160161-Atma Ram Memorial Convent School,2,9,9,0,3,6,100,33.33
2090,109-JAIPUR,170345-Sunrise Sr.sec. Public School,2,9,9,0,9,0,100,100
2091,109-JAIPUR,170153-Govt. Hr. Sec. School,2,9,8,1,8,0,88.89,88.89
2092,105-CHANDIGARH,050530-Maharishi International Public Sch.,2,9,9,0,4,5,100,44.44
2093,115-BHUBANESWAR,150188-Centurion Public School,2,9,9,0,4,5,100,44.44
2094,113-BHOPAL,100109-Saraswati Gyan Mandir High School,2,9,0,9,0,0,0,0
2095,111-ALLAHABAD/PRAYAGRAJ,210432-Jawahar Navodaya Vidyalaya,2,9,8,1,8,0,88.89,88.89
2096,105-CHANDIGARH,M16102-Sant Baba Attar Singh Public School,2,9,8,1,5,3,88.89,55.56
2097,106-KOCHI,M09095-A.u.p. School,2,9,9,0,9,0,100,100
2098,115-BHUBANESWAR,150204-Dronacharya School,2,9,7,2,5,2,77.78,55.56
2099,103-KOLKATA,220102-Kendriya Vidyalaya,2,9,9,0,0,9,100,0
2100,121-CHENNAI,420112-Sri Sankara Vidyalaya Mat. Hr. Sec. School,2,9,9,0,0,9,100,0
2101,120-RANCHI,"450175-Deepsikha, ICD & MH",2,9,0,9,0,0,0,0
2102,111-ALLAHABAD/PRAYAGRAJ,M21286-St. Jude's Inter College,2,9,9,0,7,2,100,77.78
2103,102-PUNE,TM2801-Montfort Industrial Training Institute,2,9,9,0,9,0,100,100
2104,111-ALLAHABAD/PRAYAGRAJ,210794-Shri Mahipal Shastri Inter College,2,9,9,0,7,2,100,77.78
2105,104-GUWAHATI,200030-Manughat Class Xii School,2,9,9,0,9,0,100,100
2106,104-GUWAHATI,240029-Govt. Higher Secondary School,2,9,9,0,9,0,100,100
2107,106-KOCHI,T09001-Govt. ITI Kalamassery,4,8,8,0,8,0,100,100
2108,110-PATNA,030261-R.b.+2 Inter School,2,8,8,0,4,4,100,50
2109,105-CHANDIGARH,160152-Cambridge Convent High School,2,8,8,0,8,0,100,100
2110,102-PUNE,110150-Orchids The International School,2,8,8,0,7,1,100,87.5
2111,102-PUNE,M38333-Salahuddin Ayyubi Memorial Urdu,2,8,7,1,4,3,87.5,50
2112,110-PATNA,030246-Govt.girls Higher Secondary School,2,8,8,0,1,7,100,12.5
2113,101-HYDERABAD,470023-P R R Jr. College,3,8,8,0,8,0,100,100
2114,107-DELHI,M21662-AYESHA PUBLIC SCHOOL,2,8,0,8,0,0,0,0
2115,121-CHENNAI,190173-Tagore Senior Secondary School,2,8,0,8,0,0,0,0
2116,105-CHANDIGARH,050388-Apex Public School,2,8,6,2,2,4,75,25
2117,121-CHENNAI,190105-Mathagondapalli Model School,2,8,8,0,6,2,100,75
2118,105-CHANDIGARH,160093-Sidana International School,2,8,8,0,4,4,100,50
2119,113-BHOPAL,100294-Anupama Higher Secondary School,4,8,0,8,0,0,0,0
2120,109-JAIPUR,170421-Akash Science Academy Sr. Sec. School,2,8,8,0,8,0,100,100
2121,105-CHANDIGARH,160140-Chopra Public School,3,8,8,0,8,0,100,100
2122,120-RANCHI,260025-Ramakrishna Mission English School,2,8,5,3,0,5,62.5,0
2123,114-DEHRADUN,340234-Govt. Inter College,2,8,8,0,7,1,100,87.5
2124,121-CHENNAI,190170-Vivekananda Vision School,2,8,8,0,6,2,100,75
2125,118-GANDHINAGAR,040050-Kendriya Vidyalaya,4,8,8,0,5,3,100,62.5
2126,111-ALLAHABAD/PRAYAGRAJ,210532-Jawahar Navodaya Vidyalaya,2,8,8,0,5,3,100,62.5
2127,103-KOLKATA,220047-Kendriya Vidyalaya No. 2,2,8,8,0,0,8,100,0
2128,117-BENGALURU,080030-Kendriya Vidalaya,3,8,8,0,4,4,100,50
2129,113-BHOPAL,100173-Adarsh Adivasi High School,2,8,0,8,0,0,0,0
2130,109-JAIPUR,170141-Govt. Sr.sec.school,2,8,7,1,7,0,87.5,87.5
2131,104-GUWAHATI,M14025-Little Flower Higher Secondary,2,8,8,0,8,0,100,100
2132,111-ALLAHABAD/PRAYAGRAJ,210680-Urmil Unique Central Academy,2,8,8,0,8,0,100,100
2133,123-GANGTOK,180018-Govt. Senior Secondary School,3,8,8,0,7,1,100,87.5
2134,119-RAIPUR,290151-Govt. Hr.sec. School,1,7,6,1,4,2,85.71,57.14
2135,114-DEHRADUN,M21642-Meerut Girls Inter College,1,7,7,0,5,2,100,71.43
2136,114-DEHRADUN,210725-J.P. Academy Public School,1,7,7,0,7,0,100,100
2137,102-PUNE,360122-Sri Ma Vidyalaya Patlipada,2,7,7,0,7,0,100,100
2138,114-DEHRADUN,210617-Doon Hills Academy,2,7,7,0,6,1,100,85.71
2139,109-JAIPUR,170150-Govt. Hr. Sec. School,2,7,7,0,7,0,100,100
2140,114-DEHRADUN,M21308-Muslima Girls Inter College,3,7,5,2,4,1,71.43,57.14
2141,121-CHENNAI,190046-Govt. Girls Hr. Sec. School,2,7,7,0,4,3,100,57.14
2142,104-GUWAHATI,200026-Marachara Class Xii School,2,7,7,0,5,2,100,71.43
2143,114-DEHRADUN,210720-Aarti Memorial Sr.Sec.Public School,3,7,7,0,3,4,100,42.86
2144,106-KOCHI,090008-Bharata Mata College,3,7,7,0,6,1,100,85.71
2145,122-DHARAMSALA,060051-J.c.b. Public Sr.sec.publilc School,2,7,0,7,0,0,0,0
2146,121-CHENNAI,310001-Kendriya Vidyalaya,3,7,0,7,0,0,0,0
2147,111-ALLAHABAD/PRAYAGRAJ,210179-Shri Sunil Kumar Shiksha Inter collage,3,7,6,1,3,3,85.71,42.86
2148,121-CHENNAI,420101-Blossom Public School,2,7,0,7,0,0,0,0
2149,114-DEHRADUN,340242-Govt. Inter College,2,7,6,1,4,2,85.71,57.14
2150,122-DHARAMSALA,"060050-Jai Him Nav Jyoti Sr. Sec. School,",2,7,7,0,7,0,100,100
2151,111-ALLAHABAD/PRAYAGRAJ,M21391-Global Oriental School,2,7,7,0,6,1,100,85.71
2152,120-RANCHI,260130-K.n. +2 High School,2,7,0,7,0,0,0,0
2153,111-ALLAHABAD/PRAYAGRAJ,320604-Hq 4 Rapid,1,7,3,4,2,1,42.86,28.57
2154,102-PUNE,M38212-Anglo Urdu Boys High School & Jr,2,7,7,0,6,1,100,85.71
2155,107-DELHI,270262-Sarvodaya Bal Vidyalaya,1,7,0,7,0,0,0,0
2156,114-DEHRADUN,340240-Tibetan Homes School,2,7,7,0,3,4,100,42.86
2157,114-DEHRADUN,210679-Loyal Public School,3,7,7,0,2,5,100,28.57
2158,120-RANCHI,260148-Govt. High School,2,7,7,0,7,0,100,100
2159,118-GANDHINAGAR,390109-Govt. Sec. & Hr. Sec. School,2,7,7,0,7,0,100,100
2160,121-CHENNAI,190171-Shrine vailankanni Sr. Sec. School,3,7,6,1,6,0,85.71,85.71
2161,113-BHOPAL,100291-Hitkari Hr.sec. School,2,7,0,7,0,0,0,0
2162,120-RANCHI,M26188-HOLY CROSS SCHOOL,2,7,0,7,0,0,0,0
2163,109-JAIPUR,170321-New Adarsh Senior Secondary School,1,7,6,1,6,0,85.71,85.71
2164,107-DELHI,270420-Dhanpatmal Virmani Sr.sec.school,1,7,0,7,0,0,0,0
2165,118-GANDHINAGAR,390080-Saurabh English School,2,7,7,0,7,0,100,100
2166,114-DEHRADUN,210636-S.b.d.m. Intermediate College,3,7,7,0,1,6,100,14.29
2167,118-GANDHINAGAR,040063-Savvy International School,2,7,7,0,7,0,100,100
2168,115-BHUBANESWAR,150054-Ekalavya Model Residential School,2,7,6,1,5,1,85.71,71.43
2169,103-KOLKATA,180005-Fiveways School,2,7,7,0,4,3,100,57.14
2170,102-PUNE,M36123-St. Ursula High School,2,7,7,0,7,0,100,100
2171,123-GANGTOK,180006-Kendriya Vidyalaya,2,7,4,3,3,1,57.14,42.86
2172,113-BHOPAL,100024-Maharishi Vidya Mandir,1,7,7,0,7,0,100,100
2173,105-CHANDIGARH,050667-Northern International School,2,7,7,0,3,4,100,42.86
2174,111-ALLAHABAD/PRAYAGRAJ,210106-Kids Corner Happy Sr. Sec. School,1,7,6,1,2,4,85.71,28.57
2175,103-KOLKATA,220015-Marwari Panchayat Charity Trust,1,6,6,0,6,0,100,100
2176,120-RANCHI,260135-+2 High School,2,6,0,6,0,0,0,0
2177,106-KOCHI,M09062-Mit Trust English Medium School,1,6,6,0,6,0,100,100
2178,111-ALLAHABAD/PRAYAGRAJ,210032-Kendriya Vidyalaya,2,6,6,0,5,1,100,83.33
2179,113-BHOPAL,"100093-Mata Beti Bai Public School,",2,6,0,6,0,0,0,0
2180,102-PUNE,110120-Jawahar Navodaya Vidyalaya,1,6,6,0,4,2,100,66.67
2181,109-JAIPUR,170300-Bhoomija Sr.sec. School,1,6,4,2,4,0,66.67,66.67
2182,122-DHARAMSALA,060024-Sanjay Gandhi Public Sr.sec School,1,6,0,6,0,0,0,0
2183,105-CHANDIGARH,050402-New Pragati Senior Secondary School,2,6,6,0,1,5,100,16.67
2184,109-JAIPUR,170049-Mahaveer Vidya Mandir,1,6,6,0,6,0,100,100
2185,117-BENGALURU,080072-BVM GLOBAL SCHOOL BENGALURU,1,6,6,0,6,0,100,100
2186,106-KOCHI,M09061-Noorul Huda Orphanage,1,6,6,0,4,2,100,66.67
2187,114-DEHRADUN,210211-Vanasthali Public Sr.sec. School,1,6,6,0,3,3,100,50
2188,105-CHANDIGARH,160076-Jawahar Navodaya Vidyalaya,1,6,4,2,2,2,66.67,33.33
2189,114-DEHRADUN,340223-Govt. Inter College,2,6,6,0,3,3,100,50
2190,121-CHENNAI,310006-Annai Teresa Govt. Girls Hr. Sec.,1,6,0,6,0,0,0,0
2191,109-JAIPUR,170148-Adarsh Gyan Mandir Sr.sec. School,2,6,5,1,5,0,83.33,83.33
2192,115-BHUBANESWAR,150032-Oriental Public School,2,6,5,1,3,2,83.33,50
2193,115-BHUBANESWAR,410114-Ravenshaw Collegiate School,1,6,5,1,4,1,83.33,66.67
2194,104-GUWAHATI,320108-58 GTC,1,6,6,0,3,3,100,50
2195,114-DEHRADUN,M38371-Madrasa Mahaboobiya High School,1,6,5,1,1,4,83.33,16.67
2196,110-PATNA,030028-Kendriya Vidyalaya No.-2,2,6,6,0,2,4,100,33.33
2197,111-ALLAHABAD/PRAYAGRAJ,M21652-Sir Syed Public School,1,6,6,0,5,1,100,83.33
2198,123-GANGTOK,180014-Govt. Senior Secondary School,1,6,6,0,3,3,100,50
2199,109-JAIPUR,M38272-Maulana Abul Kalam Azad Muslim,1,6,4,2,4,0,66.67,66.67
2200,113-BHOPAL,M38256-Madarsa Hazrat Bilal,1,6,5,1,5,0,83.33,83.33
2201,102-PUNE,110149-Army Public School,1,6,6,0,5,1,100,83.33
2202,107-DELHI,270414-Muni International School,1,6,6,0,6,0,100,100
2203,118-GANDHINAGAR,040104-P. Chandra International School,2,6,6,0,2,4,100,33.33
2204,107-DELHI,050611-M D Senior Secondary School,1,6,0,6,0,0,0,0
2205,114-DEHRADUN,340263-Adarsh Hr. Sec. School,1,6,6,0,3,3,100,50
2206,110-PATNA,030011-Jawahar Navodaya Vidyalaya,1,6,6,0,2,4,100,33.33
2207,106-KOCHI,M09102-Bappuji English Medium School,2,6,6,0,6,0,100,100
2208,114-DEHRADUN,M38237-Jamia Farooquia Azizul Uloom,1,6,4,2,1,3,66.67,16.67
2209,120-RANCHI,260094-+2 High School,1,6,0,6,0,0,0,0
2210,114-DEHRADUN,340123-Govt. Inter College,2,6,5,1,1,4,83.33,16.67
2211,120-RANCHI,260054-D.a.v. Public School Barkakana,2,6,5,1,4,1,83.33,66.67
2212,109-JAIPUR,170366-Navodaya Bal Senior Sec. School,1,6,6,0,6,0,100,100
2213,111-ALLAHABAD/PRAYAGRAJ,210414-Jawahar Navodaya Vidyalaya,1,6,6,0,5,1,100,83.33
2214,120-RANCHI,260111-+2 High School,2,6,0,6,0,0,0,0
2215,107-DELHI,210722-Ganga Inter National College,1,6,0,6,0,0,0,0
2216,107-DELHI,050337-Genius Convent Sr. Sec. School,1,6,0,6,0,0,0,0
2217,118-GANDHINAGAR,040052-Gangadhara High School,1,6,6,0,6,0,100,100
2218,103-KOLKATA,189001-Regional Centre-Gangtok,1,6,6,0,5,1,100,83.33
2219,107-DELHI,210394-Gautam Public Hr.sec.school,1,6,0,6,0,0,0,0
2220,102-PUNE,110131-Kendriya Vidyalaya,1,6,6,0,5,1,100,83.33
2221,114-DEHRADUN,210764-S.K.D Public School,1,6,6,0,2,4,100,33.33
2222,107-DELHI,050102-Navyug High School,1,6,6,0,6,0,100,100
2223,114-DEHRADUN,340102-Maharishi Vidya Mandir,2,6,6,0,2,4,100,33.33
2224,105-CHANDIGARH,160092-Doon Valley Cambridge School,1,6,6,0,3,3,100,50
2225,111-ALLAHABAD/PRAYAGRAJ,210620-Premchandra Shivdhara Inter College,1,6,6,0,6,0,100,100
2226,121-CHENNAI,190018-Veera Savarkar Netaji Matric.school,2,6,6,0,5,1,100,83.33
2227,111-ALLAHABAD/PRAYAGRAJ,210435-Jawahar Navodaya Vidyalaya,1,6,6,0,5,1,100,83.33
2228,114-DEHRADUN,340231-Govt. Intermediate College,1,6,6,0,4,2,100,66.67
2229,105-CHANDIGARH,050609-Aravali Modern School,1,6,6,0,1,5,100,16.67
2230,111-ALLAHABAD/PRAYAGRAJ,M21544-Al Jamiatul Islamia Khairul Uloom,1,6,6,0,6,0,100,100
2231,115-BHUBANESWAR,410006-Govt. Higher Secondary School,1,6,5,1,3,2,83.33,50
2232,123-GANGTOK,180008-Govt. Senior Secondary School,1,6,6,0,4,2,100,66.67
2233,116-VISAKHAPATNAM,470221-Silver Oaks High School,2,6,5,1,5,0,83.33,83.33
2234,104-GUWAHATI,140028-Govt. Higher Secondary School,1,6,6,0,5,1,100,83.33
2235,122-DHARAMSALA,060012-Govt. Sr. Sec. School,1,6,0,6,0,0,0,0
2236,114-DEHRADUN,M21661-Delhi Public Global School,2,6,6,0,3,3,100,50
2237,107-DELHI,M27476-Shiv Modern Senior Secondary School,1,6,0,6,0,0,0,0
2238,111-ALLAHABAD/PRAYAGRAJ,210330-Kanpur Public School,1,6,6,0,5,1,100,83.33
2239,104-GUWAHATI,020052-Jawahar Navodaya Vidyalaya,1,6,6,0,6,0,100,100
2240,125-JAMMU,070038-Jawahar Navodaya Vidyalaya,2,6,6,0,5,1,100,83.33
2241,121-CHENNAI,320412-The Madras Regimental Centre,2,6,0,6,0,0,0,0
2242,120-RANCHI,260172-K.b.s.s.+2 High School,1,6,0,6,0,0,0,0
2243,111-ALLAHABAD/PRAYAGRAJ,210760-Pt. Gupt Ram Pandey Adarsh Inter College,2,6,4,2,3,1,66.67,50
2244,109-JAIPUR,170099-Kendriya Vidyalaya,1,6,6,0,3,3,100,50
2245,105-CHANDIGARH,050237-Vivekanand Sr. Sec. School,1,6,6,0,3,3,100,50
2246,120-RANCHI,260085-Jawahar Navodaya Vidyalaya,1,6,0,6,0,0,0,0
2247,114-DEHRADUN,340213-Govt. Inter College,2,6,6,0,6,0,100,100
2248,105-CHANDIGARH,160134-Guru Nanak Public School,1,6,6,0,4,2,100,66.67
2249,103-KOLKATA,230006-Govt. Girls Sr. Sec School,1,6,6,0,0,6,100,0
2250,121-CHENNAI,190054-Govt. Higher Secondary School,1,6,6,0,6,0,100,100
2251,104-GUWAHATI,440003-Orang Higher Secondary School,1,6,6,0,4,2,100,66.67
2252,104-GUWAHATI,020019-Little Flower School,2,6,6,0,5,1,100,83.33
2253,120-RANCHI,260195-Name 5141,1,6,0,6,0,0,0,0
2254,104-GUWAHATI,240030-Govt. Higher Secondary School,1,6,6,0,6,0,100,100
2255,120-RANCHI,260102-Smt. Anarkali +2 School,1,6,0,6,0,0,0,0
2256,111-ALLAHABAD/PRAYAGRAJ,M21493-Madarsa Muskan,1,6,6,0,3,3,100,50
2257,118-GANDHINAGAR,040062-M.B. Patel Gyanjot Vidhya Vihar,1,6,6,0,5,1,100,83.33
2258,107-DELHI,"G27048-Govt Sarvodaya Kanya Vidalaya, H Block , Phase -1 Ashok Vihar, North West B Delhi-110052",2,6,0,6,0,0,0,0
2259,115-BHUBANESWAR,150187-Brajendra High School,1,6,5,1,4,1,83.33,66.67
2260,114-DEHRADUN,340318-Doon Bhawani International School,1,6,6,0,3,3,100,50
2261,103-KOLKATA,M22073-St. Thomas High School,2,6,6,0,1,5,100,16.67
2262,116-VISAKHAPATNAM,010150-Sri Pragyna Junior College,1,6,6,0,6,0,100,100
2263,104-GUWAHATI,020066-Name 5178,2,6,6,0,6,0,100,100
2264,121-CHENNAI,310011-Navalar Nedunchezhian Govt.Hr.Sec.School,1,6,0,6,0,0,0,0
2265,110-PATNA,030327-Rajkiya Girls +2 High School,1,6,6,0,2,4,100,33.33
2266,102-PUNE,M11089-N.t.c.c High School,1,5,5,0,5,0,100,100
2267,105-CHANDIGARH,050489-Pushpa Kanya Sr. Secondary School,1,5,5,0,4,1,100,80
2268,113-BHOPAL,100166-Ram Sundar Higher Secondary School,1,5,0,5,0,0,0,0
2269,116-VISAKHAPATNAM,010209-HEAL SCHOOL,1,5,5,0,4,1,100,80
2270,103-KOLKATA,220101-Kendriya Vidyalaya,1,5,5,0,4,1,100,80
2271,105-CHANDIGARH,050581-MAA BHAGWATI NIKETAN PUBLIC SCHOOL,1,5,5,0,2,3,100,40
2272,109-JAIPUR,170136-Lady Anusuya Singhania Educational,1,5,5,0,5,0,100,100
2273,117-BENGALURU,V08001-Arundhati Gurukulam,1,5,5,0,5,0,100,100
2274,114-DEHRADUN,340112-Govt. Inter College,1,5,5,0,3,2,100,60
2275,113-BHOPAL,100311-Noble Public School,1,5,5,0,3,2,100,60
2276,120-RANCHI,260193-Saraswati Shishu Vidya Mandir,1,5,0,5,0,0,0,0
2277,111-ALLAHABAD/PRAYAGRAJ,210793-Pahalwan Gurudeen Public School,1,5,5,0,4,1,100,80
2278,111-ALLAHABAD/PRAYAGRAJ,M38179-Saint Kabir Inter College,1,5,5,0,5,0,100,100
2279,122-DHARAMSALA,060063-Shivalik Public Sr.sec.school,1,5,0,5,0,0,0,0
2280,113-BHOPAL,"100060-Vidya Bharti Higher Sec School,",1,5,0,5,0,0,0,0
2281,111-ALLAHABAD/PRAYAGRAJ,210582-Raj Devi Ram Karan Public School,1,5,5,0,4,1,100,80
2282,125-JAMMU,070033-Jawahar Navodaya Vidyalaya,1,5,5,0,4,1,100,80
2283,102-PUNE,110075-Shri Bhavani Vidyamandir,1,5,5,0,5,0,100,100
2284,121-CHENNAI,M19106-PERAL MATRICULATION SCHOOL,1,5,0,5,0,0,0,0
2285,104-GUWAHATI,020030-Kendriya Vidyalaya,1,5,5,0,5,0,100,100
2286,113-BHOPAL,100142-Jawahar Navodaya Vidyalaya,1,5,0,5,0,0,0,0
2287,105-CHANDIGARH,050027-St. Theresa's Convent School,2,5,3,2,3,0,60,60
2288,104-GUWAHATI,020079-L.N. Bezbarua High School,1,5,5,0,5,0,100,100
2289,104-GUWAHATI,140018-Neingulie Memorial High School,1,5,5,0,5,0,100,100
2290,121-CHENNAI,190087-Kendriya Vidyalaya,1,5,0,5,0,0,0,0
2291,113-BHOPAL,100092-Baba Nepali Higher Secondary School,1,5,0,5,0,0,0,0
2292,116-VISAKHAPATNAM,010144-Sri Harsha's Junior  & Degree,1,5,5,0,5,0,100,100
2293,109-JAIPUR,170355-Hukumchand Public School,1,5,3,2,3,0,60,60
2294,118-GANDHINAGAR,390125-Radhe International School,1,5,5,0,4,1,100,80
2295,107-DELHI,210746-Sidhi Vinayak Public School,1,5,0,5,0,0,0,0
2296,105-CHANDIGARH,050625-St. Simran Public School,1,5,5,0,4,1,100,80
2297,111-ALLAHABAD/PRAYAGRAJ,M21660-AL HAFEEZ EDUCATIONAL ACADEMY,1,5,5,0,4,1,100,80
2298,102-PUNE,360109-Bharti Sanskrit Vidya Niketaram,1,5,5,0,5,0,100,100
2299,109-JAIPUR,M38315-Khawaja Model School,1,5,0,5,0,0,0,0
2300,113-BHOPAL,100198-Jawahar Navodaya Vidyalaya,1,5,0,5,0,0,0,0
2301,104-GUWAHATI,120058-Christian Model English Higher Secondary School,1,5,5,0,5,0,100,100
2302,105-CHANDIGARH,050598-Rajwanshi Shiksha Niketan Sr. Sec. School,1,5,5,0,3,2,100,60
2303,119-RAIPUR,290140-Govt. Boys Higher Secondary School,1,5,5,0,4,1,100,80
2304,113-BHOPAL,100137-Jawahar Navodaya Vidyalaya,1,5,0,5,0,0,0,0
2305,105-CHANDIGARH,160126-R.P. International Sr.Sec. School,1,5,4,1,2,2,80,40
2306,109-JAIPUR,170327-Manju Public Sr. Secondary School,1,5,5,0,4,1,100,80
2307,121-CHENNAI,420104-BVM GLOBAL BOLLINENI HILLSIDE SENIOR SECONDARY SCHOOL,1,5,5,0,0,5,100,0
2308,110-PATNA,030260-J.n.k.t.inter School,1,5,5,0,2,3,100,40
2309,103-KOLKATA,230002-Govt. Senior Secondary School,1,5,5,0,0,5,100,0
2310,113-BHOPAL,100086-Vishwa Bharti Higher Sec. School,1,5,0,5,0,0,0,0
2311,111-ALLAHABAD/PRAYAGRAJ,210421-Vansha Devi Inter College,1,5,5,0,4,1,100,80
2312,120-RANCHI,260116-Sarvodaya +2 High School,1,5,0,5,0,0,0,0
2313,103-KOLKATA,220064-B.d.memorial English High School,1,5,5,0,0,5,100,0
2314,105-CHANDIGARH,050119-Swami Vivekanand Modern School,1,5,5,0,3,2,100,60
2315,105-CHANDIGARH,050560-Deewal Interrnational School,1,5,5,0,3,2,100,60
2316,109-JAIPUR,170110-Kamalnishtha Vidya Niketan,1,5,5,0,5,0,100,100
2317,105-CHANDIGARH,050514-Satluj Senior Secondary School,1,5,5,0,4,1,100,80
2318,104-GUWAHATI,M02066-CENTRAL PUBLIC SCHOOL,1,5,5,0,4,1,100,80
2319,105-CHANDIGARH,160075-Jawahar Navodaya Vidyalaya,1,5,5,0,4,1,100,80
2320,120-RANCHI,260096-Zila School,1,5,0,5,0,0,0,0
2321,107-DELHI,270482-James Convent School,1,5,0,5,0,0,0,0
2322,110-PATNA,030093-Satyendra Narayan Mahila Maha-,1,5,5,0,2,3,100,40
2323,105-CHANDIGARH,160146-N.R.M. HOLLY HEART CONVENT SCHOOL,1,5,5,0,4,1,100,80
2324,106-KOCHI,M09086-Aes Public School,1,5,5,0,5,0,100,100
2325,111-ALLAHABAD/PRAYAGRAJ,210059-Mahanagar Boys Inter College,1,5,5,0,5,0,100,100
2326,111-ALLAHABAD/PRAYAGRAJ,210708-GAURI SHANKAR PUBLIC SCHOOL,2,5,5,0,5,0,100,100
2327,118-GANDHINAGAR,390160-Sandipani Gurukul Vidhyalay,1,5,5,0,5,0,100,100
2328,111-ALLAHABAD/PRAYAGRAJ,210013-St. Queen Mary's Public School,1,5,5,0,4,1,100,80
2329,114-DEHRADUN,340314-DR. B.R.A INTER COLLEGE,1,5,5,0,3,2,100,60
2330,114-DEHRADUN,210784-Divine Global Academy,1,5,4,1,2,2,80,40
2331,115-BHUBANESWAR,410102-Govt. High School,1,5,4,1,3,1,80,60
2332,105-CHANDIGARH,050430-Global Public School,1,5,5,0,0,5,100,0
2333,102-PUNE,M38267-Fazlani L'academie Globale,1,5,5,0,4,1,100,80
2334,114-DEHRADUN,M38369-Pragati Senior Secondary School,1,5,0,5,0,0,0,0
2335,121-CHENNAI,420059-Kendriya Vidyalaya,1,5,0,5,0,0,0,0
2336,111-ALLAHABAD/PRAYAGRAJ,210788-Paras Public School,1,5,5,0,3,2,100,60
2337,110-PATNA,450093-J.m.institute Of Speech & Hearing,1,5,5,0,2,3,100,40
2338,111-ALLAHABAD/PRAYAGRAJ,210147-Saint Vivekanandsr.sec.publicschool,1,5,5,0,5,0,100,100
2339,105-CHANDIGARH,050659-Vidyantriksh Sr. Sec. School,1,5,5,0,2,3,100,40
2340,120-RANCHI,260150-R.k.+2 High School,1,5,5,0,5,0,100,100
2341,111-ALLAHABAD/PRAYAGRAJ,210739-Guruteg Bahadur Educational Academy,1,5,5,0,4,1,100,80
2342,110-PATNA,030374-JAWAHAR NAVODAYA VIDYALAYA,1,5,5,0,2,3,100,40
2343,105-CHANDIGARH,050471-S.d.senior Secondary School,1,5,5,0,5,0,100,100
2344,105-CHANDIGARH,050001-Janta Kalyan Samiti,1,5,5,0,2,3,100,40
2345,109-JAIPUR,170325-Sh. Narayan Sr.sec. School,1,5,5,0,5,0,100,100
2346,125-JAMMU,"320525-Hrdc, Hq",1,5,5,0,3,2,100,60
2347,117-BENGALURU,080069-Patel Public School,1,5,5,0,4,1,100,80
2348,105-CHANDIGARH,M16110-Nightingle Sr.Sec. School,1,5,5,0,3,2,100,60
2349,121-CHENNAI,190037-Kendriya Vidydalaya,1,5,0,5,0,0,0,0
2350,111-ALLAHABAD/PRAYAGRAJ,210639-Sh. Ramesh Chandra I.c. Sonai,1,5,5,0,4,1,100,80
2351,107-DELHI,210727-Vidhan Public School,1,5,0,5,0,0,0,0
2352,105-CHANDIGARH,050276-Bal Bharti Adarsh Vidhyalaya,1,5,5,0,0,5,100,0
2353,102-PUNE,M11130-Iqra English Medium school,1,5,5,0,5,0,100,100
2354,107-DELHI,J05286-District  Jail,1,5,0,5,0,0,0,0
2355,115-BHUBANESWAR,450114-Social Welfare Agency & Training,1,5,5,0,3,2,100,60
2356,105-CHANDIGARH,050509-Hindu Senior Secondary School,1,5,5,0,3,2,100,60
2357,109-JAIPUR,M17273-Hazrat Omar Bin Kattab Pvt. ITI,1,5,5,0,5,0,100,100
2358,113-BHOPAL,M10275-Madarsa Talimul Quran,1,5,5,0,0,5,100,0
2359,109-JAIPUR,170336-Parmarth Khetaramji Sr.sec. Scchool,1,5,5,0,5,0,100,100
2360,105-CHANDIGARH,J16004-Name 4921,2,5,5,0,5,0,100,100
2361,111-ALLAHABAD/PRAYAGRAJ,M21370-Roshan Higher Secondary School,1,5,5,0,3,2,100,60
2362,107-DELHI,270552-St. Francis Convent School,1,5,0,5,0,0,0,0
2363,105-CHANDIGARH,T16009-SHAHEED BHAGAT SINGH PVT. ITI,3,5,5,0,5,0,100,100
2364,111-ALLAHABAD/PRAYAGRAJ,210468-Pt. Ram Sahay Sharma Inter College,1,5,5,0,4,1,100,80
2365,120-RANCHI,260129-+2 High School,1,5,0,5,0,0,0,0
2366,103-KOLKATA,220131-Holy Christ Secondary School,1,5,5,0,0,5,100,0
2367,102-PUNE,110132-Sudershan English High School &,1,5,5,0,5,0,100,100
2368,121-CHENNAI,190079-Govt. Hr. Sec. School,1,5,0,5,0,0,0,0
2369,113-BHOPAL,"100077-Scope Public School,",1,5,5,0,0,5,100,0
2370,118-GANDHINAGAR,040080-Shree Krishna Secondary Higher Secondary School,1,5,5,0,5,0,100,100
2371,111-ALLAHABAD/PRAYAGRAJ,210633-Sardar Raj Narayan Yadav Inter,1,5,5,0,4,1,100,80
2372,125-JAMMU,070043-Jawahar Navodaya Vidyalaya,1,5,5,0,2,3,100,40
2373,105-CHANDIGARH,160166-Holy Angels Smart School,1,5,5,0,4,1,100,80
2374,111-ALLAHABAD/PRAYAGRAJ,210780-M G International School,1,5,5,0,4,1,100,80
2375,110-PATNA,030418-P.K.JHA UCHCHATER MADHYMIK VIDHYALAYA ,1,5,5,0,2,3,100,40
2376,110-PATNA,"030344-+2 High School,",1,5,5,0,1,4,100,20
2377,114-DEHRADUN,210675-Dron Public School,1,5,5,0,2,3,100,40
2378,107-DELHI,270424-Pragati Public School,1,5,0,5,0,0,0,0
2379,115-BHUBANESWAR,150139-Govt. (ssd) Girls High School,1,5,3,2,2,1,60,40
2380,104-GUWAHATI,140031-Govt. High School,1,5,5,0,5,0,100,100
2381,107-DELHI,270550-R K Memorial Public School,1,5,0,5,0,0,0,0
2382,122-DHARAMSALA,060100-Army Public School,1,5,4,1,0,4,80,0
2383,104-GUWAHATI,"020025-Kendriya Vidyalaya Afs,",1,5,5,0,4,1,100,80
2384,109-JAIPUR,170279-Stanford Global Academy,1,5,4,1,4,0,80,80
2385,118-GANDHINAGAR,040097-Brahmani Vidhyalay,1,5,5,0,4,1,100,80
2386,125-JAMMU,070060-Army Public School,1,5,5,0,5,0,100,100
2387,103-KOLKATA,220130-Gocharan North Point Institute,1,5,5,0,0,5,100,0
2388,113-BHOPAL,100002-Asha Kala Kendra,1,5,0,5,0,0,0,0
2389,110-PATNA,030008-Jawahar Navodaya Vidyalaya,1,5,5,0,0,5,100,0
2390,107-DELHI,270349-Govt.sarvodaya Co-ed. Sr.sec.school,1,5,0,5,0,0,0,0
2391,106-KOCHI,400048-Kendriya Vidyalaya,1,5,5,0,4,1,100,80
2392,110-PATNA,030197-Rajkiyakrit Ucchvidyalaya,1,5,5,0,2,3,100,40
2393,105-CHANDIGARH,160163-Adarsh Modern High School,1,5,5,0,3,2,100,60
2394,120-RANCHI,260174-Govt. Govind +2 School,1,5,0,5,0,0,0,0
2395,117-BENGALURU,M08020-Excellent English School,1,5,5,0,5,0,100,100
2396,122-DHARAMSALA,060042-B.l. Central Public School,1,5,0,5,0,0,0,0
2397,115-BHUBANESWAR,"410035-410035-Govt.(SSD) High School, Dabugam",1,5,3,2,3,0,60,60
2398,121-CHENNAI,190060-Govt. Hr. Sec. School,1,5,0,5,0,0,0,0
2399,102-PUNE,M11128-Al Ameen English High School,1,5,5,0,5,0,100,100
2400,105-CHANDIGARH,050507-Ch. Neki Ram Public School,1,5,4,1,0,4,80,0
2401,107-DELHI,050322-Vidya Niketan Sr.sec. School,1,5,0,5,0,0,0,0
2402,125-JAMMU,070017-Girls Higher Sec. School,2,5,5,0,3,2,100,60
2403,107-DELHI,050642-B S M High School,1,5,0,5,0,0,0,0
2404,115-BHUBANESWAR,150095-Govt. High School,1,5,4,1,3,1,80,60
2405,105-CHANDIGARH,050200-Evergreen High School,1,5,5,0,1,4,100,20
2406,114-DEHRADUN,340274-Baluni Public School,1,5,5,0,1,4,100,20
2407,107-DELHI,G27007-Sarvodaya Vidyalaya Badarpur Kahadar Delhi-110090,1,5,0,5,0,0,0,0
2408,105-CHANDIGARH,050453-Sarvodaya Sr.sec. School,1,5,5,0,0,5,100,0
2409,118-GANDHINAGAR,040096-Swami Vivekanand Vidhyalaya,1,5,5,0,5,0,100,100
2410,120-RANCHI,260127-Jharia Raj +2 High School,1,5,0,5,0,0,0,0
2411,106-KOCHI,M09037-Mar Ivonios Bethany School,1,5,5,0,5,0,100,100
2412,121-CHENNAI,420090-The Trinity Academy,1,5,0,5,0,0,0,0
2413,110-PATNA,"030253-High School,",1,5,5,0,0,5,100,0
2414,111-ALLAHABAD/PRAYAGRAJ,210807-Rama Convent Inter College,1,5,5,0,4,1,100,80
2415,110-PATNA,M03378-Khalikum Nisha Sajjad Millat,1,5,5,0,3,2,100,60
2416,109-JAIPUR,170197-Govt. Senior Secondary School,1,5,2,3,2,0,40,40
2417,105-CHANDIGARH,160014-Vivekanand Blessed Sr.sec. School,1,5,5,0,3,2,100,60
2418,110-PATNA,030007-Jawahar Navodaya Vidyalaya,1,5,5,0,2,3,100,40
2419,104-GUWAHATI,020055-Jawahar Navodaya Vidyalaya,1,5,5,0,5,0,100,100
2420,105-CHANDIGARH,160091-R.k.public High School,1,5,4,1,2,2,80,40
2421,107-DELHI,270488-Lavi Public School,1,5,0,5,0,0,0,0
2422,110-PATNA,030409-Chandrasheel Vidyapeeth,1,5,5,0,2,3,100,40
2423,107-DELHI,270523-CIAT Convent School,1,5,0,5,0,0,0,0
2424,105-CHANDIGARH,M16009-Guru Nanak Sr. Sec. School,1,5,5,0,4,1,100,80
2425,105-CHANDIGARH,050422-Shivaniaa Public School,1,5,5,0,4,1,100,80
2426,104-GUWAHATI,020035-Kendriya Vidyalaya,2,5,5,0,5,0,100,100
2427,105-CHANDIGARH,050051-Shiv Shakti Sr. Sec. School,1,5,5,0,3,2,100,60
2428,120-RANCHI,260141-R.n.r. +2 High School,1,5,0,5,0,0,0,0
2429,110-PATNA,030367-Jawahar Navodaya Vidyalaya,1,5,5,0,2,3,100,40
2430,120-RANCHI,M26187-Shine Valley School,1,5,0,5,0,0,0,0
2431,114-DEHRADUN,340322-New Oxford Higher Secondary School,1,5,5,0,5,0,100,100
2432,114-DEHRADUN,320315-The Kumaon Regt Centre,1,5,5,0,2,3,100,40
2433,121-CHENNAI,190059-Govt. Hr. Sec. School,1,5,0,5,0,0,0,0
2434,114-DEHRADUN,340196-Govt. Inter College,1,5,5,0,1,4,100,20
2435,110-PATNA,030062-Adarsh High School,1,5,5,0,2,3,100,40
2436,111-ALLAHABAD/PRAYAGRAJ,210681-Pd. Raj Nayan Intermediate College,1,5,4,1,3,1,80,60
2437,105-CHANDIGARH,050140-Happy Sr. Sec. School,1,5,5,0,4,1,100,80
2438,107-DELHI,210762-HINDON PUBLIC SCHOOL,2,5,0,5,0,0,0,0
2439,105-CHANDIGARH,050330-Baba Balak Nath Sr.sec. School,1,5,5,0,1,4,100,20
2440,119-RAIPUR,290088-Govt. Boys Higher Secondary School,1,5,5,0,2,3,100,40
2441,121-CHENNAI,190074-Govt. Hr. Sec. School,1,5,5,0,1,4,100,20
2442,113-BHOPAL,"100074-Vivekanand Public Hr.sec. School,",1,5,0,5,0,0,0,0
2443,105-CHANDIGARH,050521-Model Sanskriti Sr.Sec. School,1,5,5,0,3,2,100,60
2444,111-ALLAHABAD/PRAYAGRAJ,M21503-Safa Shariat College,1,5,5,0,4,1,100,80
2445,122-DHARAMSALA,060034-Govt. Senior Secondary School,1,5,0,5,0,0,0,0
2446,115-BHUBANESWAR,410002-Daniel Public School,1,5,4,1,4,0,80,80
2447,107-DELHI,050084-D.s. Arya High School,1,5,3,2,3,0,60,60
2448,105-CHANDIGARH,050652-Janta Shiksha Sadan,1,5,5,0,3,2,100,60
2449,119-RAIPUR,290168-Dr. Padumal Punnalal Buxi Model,1,5,5,0,4,1,100,80
2450,109-JAIPUR,M17269-Raza Public Sr.sec. School,1,5,3,2,3,0,60,60
2451,111-ALLAHABAD/PRAYAGRAJ,210529-Indresh Verma Vidyapeeth Balika,1,5,5,0,3,2,100,60
2452,110-PATNA,030075-M.g.smarak Ucch Vidyalaya,1,5,5,0,1,4,100,20
2453,110-PATNA,030366-Dr. Shaligram Mishra College,1,5,5,0,3,2,100,60
2454,104-GUWAHATI,140026-Govt. High School,1,5,5,0,5,0,100,100
2455,118-GANDHINAGAR,M04023-Peer Haji Alisha Bukhari High,1,5,5,0,5,0,100,100
2456,114-DEHRADUN,220127-Pearl Rosary School (New),1,5,5,0,5,0,100,100
2457,113-BHOPAL,320413-21 Corps Hrdc,1,5,4,1,0,4,80,0
2458,107-DELHI,210345-Chodhary Charan Singh Memorial Sr,1,5,0,5,0,0,0,0
2459,105-CHANDIGARH,050138-Shastri High School,1,5,5,0,1,4,100,20
2460,111-ALLAHABAD/PRAYAGRAJ,210796-Narayan College of Science and Arts,1,5,5,0,4,1,100,80
2461,102-PUNE,110122-Jawahar Navodaya Vidyalaya,1,5,4,1,4,0,80,80
2462,110-PATNA,M03358-Madarsa Ahmdia Hanfia,1,5,5,0,2,3,100,40
2463,117-BENGALURU,M08056-St. Francis School,1,5,5,0,5,0,100,100
2464,104-GUWAHATI,200035-Name 4401,1,5,5,0,3,2,100,60
2465,119-RAIPUR,290084-Jawahar Navodaya Vidyalaya,1,5,5,0,4,1,100,80
2466,121-CHENNAI,190073-Govt. Girls Hr.sec. School,1,5,0,5,0,0,0,0
2467,125-JAMMU,070036-Jawahar Navodaya Vidyalaya,1,5,5,0,3,2,100,60
2468,101-HYDERABAD,470187-Kendriya Vidyalaya,1,5,5,0,5,0,100,100
2469,110-PATNA,030399-New Horizon School,1,5,5,0,2,3,100,40
2470,122-DHARAMSALA,060033-Govt. Senior Secondary School,2,5,0,5,0,0,0,0
2471,107-DELHI,270117-Shaheed Hemu Kalani Govt. Sarvodaya,1,5,0,5,0,0,0,0
2472,119-RAIPUR,290165-Saraswati Vihar English Medium,1,5,5,0,4,1,100,80
2473,107-DELHI,270418-Mother Khazani Convent School,1,5,0,5,0,0,0,0
2474,105-CHANDIGARH,050494-Sh. Lal Bahadur Shastri High School,1,5,5,0,1,4,100,20
2475,104-GUWAHATI,020033-Kendriya Vidyalya,1,5,5,0,5,0,100,100
2476,118-GANDHINAGAR,040132-Sandipani Gurukul Vidhyalay,1,5,5,0,3,2,100,60
2477,116-VISAKHAPATNAM,370089-Vignan Talent School,1,5,5,0,2,3,100,40
2478,107-DELHI,050622-Universal Public School,1,5,0,5,0,0,0,0
2479,115-BHUBANESWAR,150049-Govt. Girls High School,1,5,4,1,3,1,80,60
2480,120-RANCHI,260137-Sant Tulsidas +2 High School,1,5,0,5,0,0,0,0
2481,111-ALLAHABAD/PRAYAGRAJ,210717-Radhika Senior Secondary School,1,5,4,1,4,0,80,80
2482,122-DHARAMSALA,060010-Govt. Sr. Sec. School,1,5,0,5,0,0,0,0
2483,117-BENGALURU,"V08004-Shubham Karoti, Maitreyee Gurukula",1,5,5,0,3,2,100,60
2484,121-CHENNAI,190097-Suddananda Vidyalaya,1,5,5,0,4,1,100,80
2485,113-BHOPAL,100098-Ekta High School,1,5,0,5,0,0,0,0
2486,111-ALLAHABAD/PRAYAGRAJ,210431-Jawahar Navodaya Vidyalaya,1,5,5,0,4,1,100,80
2487,107-DELHI,270276-Convent Of Gagan Bhatri Sr.s.school,1,5,0,5,0,0,0,0
2488,121-CHENNAI,420079-Helikx Special Learning School,1,5,0,5,0,0,0,0
2489,120-RANCHI,260194-MOTHER'S INTERNATIONAL ACADEMY,1,5,0,5,0,0,0,0
2490,102-PUNE,110121-Jawahar Navodaya Vidyalaya,1,5,5,0,4,1,100,80
2491,110-PATNA,M03233-Millat Academy Station Road,1,5,5,0,2,3,100,40
2492,111-ALLAHABAD/PRAYAGRAJ,M38184-Amiraddaula Islamia Inter College,1,5,5,0,4,1,100,80
2493,109-JAIPUR,170182-Prince International School,1,5,1,4,1,0,20,20
2494,113-BHOPAL,100068-Mahavir Singh Higher Sec. School,1,5,3,2,3,0,60,60
2495,119-RAIPUR,T29001-Jagrani Devi ITI,1,5,5,0,4,1,100,80
2496,111-ALLAHABAD/PRAYAGRAJ,210594-Maa Tripur Sundari Public School,1,5,5,0,4,1,100,80
2497,114-DEHRADUN,340226-Govt. Inter College,2,5,5,0,5,0,100,100
2498,111-ALLAHABAD/PRAYAGRAJ,210751-Green Field Aademy,1,5,5,0,5,0,100,100
2499,118-GANDHINAGAR,040061-Laxmi International School,1,4,4,0,4,0,100,100
2500,102-PUNE,"110041-Halqua E-dawanik Jr.college,",1,4,4,0,4,0,100,100
2501,121-CHENNAI,T19001-Advanced Training Institute,2,4,4,0,3,1,100,75
2502,115-BHUBANESWAR,150186-Chirstian High School,1,4,3,1,1,2,75,25
2503,104-GUWAHATI,440001-Diphu Commerce Junior College,1,4,4,0,4,0,100,100
2504,119-RAIPUR,M29158-Oriental Public School,1,4,4,0,1,3,100,25
2505,101-HYDERABAD,470158-Jawahar Navodaya Vidyalaya,1,4,4,0,1,3,100,25
2506,115-BHUBANESWAR,150176-Police High School,1,4,3,1,3,0,75,75
2507,105-CHANDIGARH,050483-Paramount Senior Secondary School,1,4,4,0,0,4,100,0
2508,121-CHENNAI,"420106-The Pupil Saveetha Eco. School,",1,4,4,0,0,4,100,0
2509,108-ABROAD/NIOS HQ,980003-Indian School,1,4,0,4,0,0,0,0
2510,118-GANDHINAGAR,040042-Kendriya Vidyalaya,1,4,4,0,2,2,100,50
2511,105-CHANDIGARH,050661-Sarvodaya Public School,1,4,4,0,3,1,100,75
2512,107-DELHI,050665-NVN School,1,4,1,3,0,1,25,0
2513,120-RANCHI,260164-Govt. +2 High School,1,4,0,4,0,0,0,0
2514,105-CHANDIGARH,160050-Star Plus Convent School,1,4,4,0,3,1,100,75
2515,117-BENGALURU,M48002-Delhi Public School,2,4,4,0,3,1,100,75
2516,118-GANDHINAGAR,040084-Govt. Khetivadi Sec. & High sec. School,1,4,4,0,1,3,100,25
2517,119-RAIPUR,290174-Vindhya Public School,1,4,4,0,3,1,100,75
2518,107-DELHI,T27001-Baba Saheb Ambedkar Industrial Training Centre,2,4,0,4,0,0,0,0
2519,120-RANCHI,260154-R.k.+2 High School,1,4,0,4,0,0,0,0
2520,103-KOLKATA,220110-Kendriya Vidyalaya,1,4,4,0,0,4,100,0
2521,105-CHANDIGARH,050539-Shaheed Udham Singh Sr. Sec. School,1,4,4,0,2,2,100,50
2522,117-BENGALURU,480001-Don Bosco Academy,1,4,4,0,2,2,100,50
2523,107-DELHI,270294-Tagore School,1,4,0,4,0,0,0,0
2524,105-CHANDIGARH,050010-D C Model High School,1,4,4,0,1,3,100,25
2525,105-CHANDIGARH,050152-Sarvodaya Shiksha Sadan,1,4,4,0,2,2,100,50
2526,113-BHOPAL,100083-Care English Hr.sec.school,1,4,4,0,0,4,100,0
2527,116-VISAKHAPATNAM,010067-S S Jr.college & Sidhartha H.school,1,4,4,0,4,0,100,100
2528,120-RANCHI,260113-+2 Hari High School,1,4,4,0,4,0,100,100
2529,101-HYDERABAD,M01199-St. Andrews High School,1,4,4,0,4,0,100,100
2530,117-BENGALURU,M08036-Al Nisa Women's Pre University,1,4,4,0,4,0,100,100
2531,105-CHANDIGARH,050293-B.r.m.sr.sec. School,1,4,4,0,0,4,100,0
2532,109-JAIPUR,M17275-MEWAT ACADEMY OF SCHOOL EDUCATION,1,4,4,0,4,0,100,100
2533,109-JAIPUR,170146-Suraj Public School,1,4,3,1,3,0,75,75
2534,113-BHOPAL,100129-Kendriya Vidyalaya,1,4,4,0,0,4,100,0
2535,118-GANDHINAGAR,390099-Jivan Vikas Education Academy,1,4,4,0,4,0,100,100
2536,109-JAIPUR,170369-Noble International School,1,4,3,1,3,0,75,75
2537,119-RAIPUR,290106-Govt. Girls Hr.sec. School,1,4,4,0,2,2,100,50
2538,115-BHUBANESWAR,T41001-Name 5131,2,4,4,0,4,0,100,100
2539,105-CHANDIGARH,160095-Sidhu Memorial Public School,1,4,4,0,2,2,100,50
2540,121-CHENNAI,"420058-Kendriya Vidyalaya,",1,4,4,0,0,4,100,0
2541,105-CHANDIGARH,160168-Meera Medical Institute of Nursing & Hospital,1,4,4,0,3,1,100,75
2542,105-CHANDIGARH,050555-Om Prakash Garg Memorial Public Sch,1,4,4,0,2,2,100,50
2543,122-DHARAMSALA,060047-Hill Grove Sr.sec.school,1,4,4,0,4,0,100,100
2544,105-CHANDIGARH,050658-Disha International School,1,4,4,0,3,1,100,75
2545,105-CHANDIGARH,050590-Saraswati Vidya Mandir Sr. Sec. School,1,4,4,0,3,1,100,75
2546,104-GUWAHATI,"240022-Kendriya Vidyalaya,",1,4,4,0,4,0,100,100
2547,105-CHANDIGARH,050468-Pratap Singh Memorial Sr.sec.school,1,4,4,0,1,3,100,25
2548,121-CHENNAI,190153-Sagar International School,1,4,0,4,0,0,0,0
2549,111-ALLAHABAD/PRAYAGRAJ,"320306-Hrdc, 11 Gorkha Rifles Regimental",1,4,4,0,3,1,100,75
2550,102-PUNE,M38180-Sir Sayyad English High School,1,4,4,0,4,0,100,100
2551,105-CHANDIGARH,050110-Nehru Senior Secondary School,1,4,4,0,0,4,100,0
2552,105-CHANDIGARH,050554-Mother Teresa Modern Public School,1,4,4,0,2,2,100,50
2553,122-DHARAMSALA,060045-St.soldier Convent Sr.sec. School,1,4,0,4,0,0,0,0
2554,121-CHENNAI,190061-Ici Govt. Hr. Sec. School,1,4,0,4,0,0,0,0
2555,105-CHANDIGARH,160070-Modern Public High School,1,4,4,0,1,3,100,25
2556,113-BHOPAL,100188-Shanti Niketan Higher Secondary,1,4,0,4,0,0,0,0
2557,125-JAMMU,070021-Unique Public Education Centre,1,4,4,0,0,4,100,0
2558,105-CHANDIGARH,T16006-P.S. Technical Institute of,2,4,4,0,4,0,100,100
2559,121-CHENNAI,420091-Kmc Public Senior Secondary School,1,4,0,4,0,0,0,0
2560,121-CHENNAI,420007-Mahatma Montessori School,3,4,0,4,0,0,0,0
2561,121-CHENNAI,M19040-Green Valley Matriculation &,1,4,3,1,2,1,75,50
2562,118-GANDHINAGAR,M04034-St.mary's School,1,4,4,0,3,1,100,75
2563,113-BHOPAL,100121-Kendriya Vidyalaya,1,4,0,4,0,0,0,0
2564,111-ALLAHABAD/PRAYAGRAJ,210765-Raksha Devi Inter College,1,4,4,0,3,1,100,75
2565,102-PUNE,110101-Cges Gulabtola High School&junior,1,4,4,0,4,0,100,100
2566,118-GANDHINAGAR,V04001-Hemachandrachary Sanskrit Pathshala,1,4,4,0,1,3,100,25
2567,113-BHOPAL,100037-Navambey Convent Hr.sec. School,1,4,0,4,0,0,0,0
2568,109-JAIPUR,170224-Jawahar Navodaya Vidyalaya,1,4,4,0,4,0,100,100
2569,107-DELHI,270042-Bal Mandir Public School,1,4,0,4,0,0,0,0
2570,116-VISAKHAPATNAM,010166-Kendriya Vidyalaya,1,4,4,0,4,0,100,100
2571,121-CHENNAI,190149-Avtar Public School,1,4,0,4,0,0,0,0
2572,122-DHARAMSALA,060093-Ajay Model Sr.sec. School,1,4,0,4,0,0,0,0
2573,114-DEHRADUN,M38345-Maa Wahida Begum High School,1,4,0,4,0,0,0,0
2574,109-JAIPUR,170220-Adarsh Naveen Sr. Secondary School,1,4,4,0,4,0,100,100
2575,105-CHANDIGARH,050171-Asha High School,1,4,4,0,1,3,100,25
2576,122-DHARAMSALA,060011-Govt. Sr.sec. School,1,4,0,4,0,0,0,0
2577,107-DELHI,270028-Yuva Shakti Model School,1,4,0,4,0,0,0,0
2578,109-JAIPUR,170418-Mata Shravani International School,1,4,4,0,3,1,100,75
2579,114-DEHRADUN,210742-H.C.M. Inter College,1,4,2,2,0,2,50,0
2580,117-BENGALURU,080029-Kandriya Vidyalaya,1,4,4,0,2,2,100,50
2581,107-DELHI,380013-Azad Memorial Inter College,1,4,0,4,0,0,0,0
2582,114-DEHRADUN,M34257-Madarsa Ishatul Haq,1,4,4,0,3,1,100,75
2583,105-CHANDIGARH,160063-A Pee Ji Public Sr.sec.school,1,4,3,1,1,2,75,25
2584,102-PUNE,110042-Holly Cross Boys High School,1,4,4,0,4,0,100,100
2585,110-PATNA,"030356-St.paul Secondary School,",2,4,4,0,3,1,100,75
2586,107-DELHI,270363-Govt. Sarvodaya Bal Vidyalaya,1,4,0,4,0,0,0,0
2587,121-CHENNAI,190053-Govt. High School,1,4,0,4,0,0,0,0
2588,107-DELHI,050164-Gyandeep Sr.sec School,1,4,0,4,0,0,0,0
2589,107-DELHI,270456-St. Matthew's Public School,1,4,0,4,0,0,0,0
2590,114-DEHRADUN,T34005-Vivekanand Mission PVT ITI,2,4,4,0,4,0,100,100
2591,114-DEHRADUN,340063-Govt. Intermediate College,1,4,4,0,0,4,100,0
2592,102-PUNE,M36110-Fr. Agnel Multipurpose School,1,4,4,0,4,0,100,100
2593,108-ABROAD/NIOS HQ,320529-HQ 19 INF Div HRDC,1,4,0,4,0,0,0,0
2594,104-GUWAHATI,200029-Ramnagar Higher Sec. School,1,3,3,0,3,0,100,100
2595,120-RANCHI,260098-R.k. +2 High School,1,3,0,3,0,0,0,0
2596,107-DELHI,050557-Karhana Sr.Sec. School,1,3,0,3,0,0,0,0
2597,106-KOCHI,090090-Govt. Hr.sec.school,1,3,3,0,3,0,100,100
2598,109-JAIPUR,170175-Govt. Maharawal Sr. Sec. School,3,3,1,2,1,0,33.33,33.33
2599,109-JAIPUR,170267-Disha Delphi Public School,1,3,3,0,3,0,100,100
2600,107-DELHI,"G27022-GOVT. BOYS SR. SEC. SCHOOL,NEAR UDYOG NAGAR METRO STATION, CAMP NO.-4 JWALAPURI NEW DELHI-87",2,3,1,2,0,1,33.33,0
2601,120-RANCHI,260204-Noamundi Inter College,1,3,0,3,0,0,0,0
2602,107-DELHI,M38370-Jesus Grace Modern School,1,3,0,3,0,0,0,0
2603,107-DELHI,"G27019-SARVODAYA BAL VIDYALAYA SUBHASH NAGAR MOD, NEAR SUBHASH NAGAR METRO STATION NEW DELHI-110027",3,3,0,3,0,0,0,0
2604,114-DEHRADUN,340313-Information Technology Institute for the India,1,3,3,0,2,1,100,66.67
2605,114-DEHRADUN,210782-Guru Govind Singh Public School,1,3,3,0,2,1,100,66.67
2606,111-ALLAHABAD/PRAYAGRAJ,210735-R.S. Convent Sainik School,1,3,3,0,2,1,100,66.67
2607,117-BENGALURU,080039-Smt. Shanthabai Edu. Society (R),1,3,3,0,2,1,100,66.67
2608,114-DEHRADUN,340261-Govt. Inter College,1,3,3,0,3,0,100,100
2609,109-JAIPUR,170198-Govt. Sr. Sec. School,1,3,3,0,3,0,100,100
2610,116-VISAKHAPATNAM,T01006-BHARAT ITI ,3,3,3,0,3,0,100,100
2611,103-KOLKATA,450180-Voice of World,3,3,3,0,3,0,100,100
2612,109-JAIPUR,170331-Sankalp Academy Sr.sec. School,1,3,3,0,3,0,100,100
2613,115-BHUBANESWAR,410142-Government High School,3,3,3,0,3,0,100,100
2614,109-JAIPUR,170449-Dadhimati Vidhya Mandir Sr Sec School,1,3,3,0,3,0,100,100
2615,106-KOCHI,090094-Jr. Baselios English Medium School,2,3,3,0,3,0,100,100
2616,109-JAIPUR,170314-Naveen Sr.sec.school,1,3,1,2,1,0,33.33,33.33
2617,104-GUWAHATI,020031-Kendriya Vidyalaya,1,2,2,0,2,0,100,100
2618,118-GANDHINAGAR,040131-Glorious Public School,1,2,2,0,1,1,100,50
2619,102-PUNE,110138-Kendriya Vidyalaya,1,2,1,1,1,0,50,50
2620,109-JAIPUR,170416-Shree  Kalyan Bal Bharti Sr. Sec. School,1,2,2,0,2,0,100,100
2621,114-DEHRADUN,T34002-Maharishi Dayanand Pvt. Industrial,1,2,2,0,1,1,100,50
2622,121-CHENNAI,190144-kids Club Senior Secondary School,1,2,0,2,0,0,0,0
2623,118-GANDHINAGAR,390089-Shree Swaminarayan Academy,1,2,2,0,2,0,100,100
2624,108-ABROAD/NIOS HQ,980004-Bridge Academy,1,2,2,0,2,0,100,100
2625,105-CHANDIGARH,M16079-Dashmesh Khals Sr.sec.school,1,2,2,0,1,1,100,50
2626,107-DELHI,450151-Manovikas School For Inclusion,1,2,1,1,0,1,50,0
2627,102-PUNE,110137-Kendriya Vidyalaya,1,2,2,0,2,0,100,100
2628,104-GUWAHATI,320118-HQ 44 Mountain Brigade,1,2,2,0,2,0,100,100
2629,114-DEHRADUN,T34001-Advanced Training Institute,1,2,2,0,1,1,100,50
2630,121-CHENNAI,190141-Vanshi Manthan Vidyashram,1,2,2,0,0,2,100,0
2631,105-CHANDIGARH,380276-Kalyan Sr.sec. School,1,2,2,0,1,1,100,50
2632,117-BENGALURU,080054-Shakuntala Patil Residential School,1,2,2,0,1,1,100,50
2633,121-CHENNAI,420060-Kendriya Vidyalaya,1,2,2,0,1,1,100,50
2634,102-PUNE,110117-Jawahar Navodaya Vidyalaya,1,2,2,0,2,0,100,100
2635,111-ALLAHABAD/PRAYAGRAJ,M21444-Eram Intermediate College,2,2,1,1,1,0,50,50
2636,109-JAIPUR,170282-Adinath Senior Sec. Public School,1,2,2,0,2,0,100,100
2637,117-BENGALURU,080070-St. Ann's English School,1,2,2,0,2,0,100,100
2638,119-RAIPUR,290119-Govt. Higher Secondary School,1,2,2,0,2,0,100,100
2639,110-PATNA,"030245-Buxar High School,",2,2,2,0,0,2,100,0
2640,107-DELHI,270527-Ran Singh Model Public School,1,2,0,2,0,0,0,0
2641,118-GANDHINAGAR,040040-K.R. DOSHI  High School,1,2,2,0,1,1,100,50
2642,113-BHOPAL,100194-Ma Veena Vadini Higher Sec. School,1,2,0,2,0,0,0,0
2643,107-DELHI,270330-Rishabh Public School,1,2,0,2,0,0,0,0
2644,115-BHUBANESWAR,"150172-150172-Govt.Boys High School,Unit-9",1,2,2,0,1,1,100,50
2645,121-CHENNAI,190176-Prasan Vidya Mandir,1,2,2,0,1,1,100,50
2646,105-CHANDIGARH,050537-Bhagat Singh Public School,1,2,2,0,1,1,100,50
2647,120-RANCHI,T26009-Gautam Buddha Pvt. ITI,1,2,0,2,0,0,0,0
2648,104-GUWAHATI,240024-Kendriya Vidyalaya,1,2,2,0,2,0,100,100
2649,110-PATNA,030069-Model Inter Vidyalaya,2,2,2,0,0,2,100,0
2650,120-RANCHI,T26005-Gurukul Private ITI,1,2,0,2,0,0,0,0
2651,103-KOLKATA,"220085-Ramakrishna Mision Ashrama,",1,2,2,0,0,2,100,0
2652,110-PATNA,M38123-Millat Academy,2,2,2,0,0,2,100,0
2653,108-ABROAD/NIOS HQ,950021-Agi's Atlas International College,2,2,2,0,2,0,100,100
2654,115-BHUBANESWAR,"410063-Govt. Girls High School,(ssd)",1,2,1,1,1,0,50,50
2655,103-KOLKATA,220030-Nepali Girls Social Service Centre,1,2,2,0,2,0,100,100
2656,120-RANCHI,T26002-Gandhian Institute of Techonology,1,2,1,1,1,0,50,50
2657,107-DELHI,"G27008-GOVT. CO-ED NEW SEELAMPUR GOVT CO-ED M. S. GURUDWARA ROAD, NEW SEELAMPUR-110053",1,2,0,2,0,0,0,0
2658,121-CHENNAI,190077-Govt. Hr. Sec. School,1,2,2,0,2,0,100,100
2659,105-CHANDIGARH,050523-Mahendra Model School,1,2,2,0,2,0,100,100
2660,107-DELHI,"G27064-Govt. Priyadarshini Sarvodaya Kanya Vidyalaya, Fatehpur Beri, South, Delhi-110074",2,2,0,2,0,0,0,0
2661,117-BENGALURU,080081-Gopalan International School,1,2,2,0,2,0,100,100
2662,105-CHANDIGARH,"T16001-Advanced Training Institute,",2,2,2,0,0,2,100,0
2663,105-CHANDIGARH,250011-Sharda Sarvihitakari Model Sr.sec.,1,2,2,0,2,0,100,100
2664,111-ALLAHABAD/PRAYAGRAJ,T21006-Gangotri Devi ITI JungleDumary No.1,1,2,2,0,2,0,100,100
2665,117-BENGALURU,"M08019-St.paul's High School,",1,2,2,0,2,0,100,100
2666,105-CHANDIGARH,T05011-Shree Shyamji Private. ITI,1,2,2,0,2,0,100,100
2667,111-ALLAHABAD/PRAYAGRAJ,T21003-Regional Voc. Training Institute,1,2,2,0,2,0,100,100
2668,113-BHOPAL,100261-Maharana Pratap Higher Sec. School,1,2,0,2,0,0,0,0
2669,111-ALLAHABAD/PRAYAGRAJ,210597-Kendriya Vidyalaya,1,2,2,0,1,1,100,50
2670,107-DELHI,270204-St. Xavier's Sr.sec.school,1,2,0,2,0,0,0,0
2671,111-ALLAHABAD/PRAYAGRAJ,M21295-John Milton Public School,2,2,2,0,2,0,100,100
2672,105-CHANDIGARH,T05006-BMP Private ITI,1,2,2,0,2,0,100,100
2673,105-CHANDIGARH,050550-Navyug Sr.Sec. School,1,2,2,0,1,1,100,50
2674,121-CHENNAI,190163-Maharishi International Residential School,1,2,2,0,1,1,100,50
2675,117-BENGALURU,M08054-Ali Public English Medium High School,1,2,2,0,2,0,100,100
2676,107-DELHI,270485-Kendriya Vidyalaya,1,2,0,2,0,0,0,0
2677,120-RANCHI,260170-R.mitra +2 School,1,2,0,2,0,0,0,0
2678,107-DELHI,"G27037-R.S.K.V. Shankar Nagar, Gandhi Nagar East, Delhi-110031",1,1,0,1,0,0,0,0
2679,100-NOIDA,270226-Sarvodaya Bal Vidyalaya,1,1,0,1,0,0,0,0
2680,107-DELHI,270306-Rajender Lakra Model School,1,1,1,0,0,1,100,0
2681,115-BHUBANESWAR,150044-Govt. Higher Secondary School,1,1,1,0,1,0,100,100
2682,105-CHANDIGARH,160130-Kalgidhar National Sr.Sec.School,1,1,1,0,1,0,100,100
2683,119-RAIPUR,290069-Jawahar Navodaya Vidyalaya,1,1,1,0,1,0,100,100
2684,110-PATNA,030384-Don Bosco School,1,1,1,0,0,1,100,0
2685,111-ALLAHABAD/PRAYAGRAJ,210098-Shyam Bihari Singh Inter College,1,1,1,0,1,0,100,100
2686,107-DELHI,270110-D A V Centenary Public School,1,1,0,1,0,0,0,0
2687,107-DELHI,"G27032-Govt.Boys Sr.Sec.School Badarpur Near DDA Flats & Post Office, South (East) Delhi-110044",1,1,0,1,0,0,0,0
2688,107-DELHI,270144-Delhi Public School,1,1,0,1,0,0,0,0
2689,121-CHENNAI,190120-Sishya School,1,1,0,1,0,0,0,0
2690,121-CHENNAI,M19105-CRESCENT RESI. MATRICULATION HIGHER SEC SCHOOL,1,1,0,1,0,0,0,0
2691,118-GANDHINAGAR,040026-Kendriya Vidyalaya,1,1,1,0,0,1,100,0
2692,107-DELHI,"G27031-Sarvodaya Bal Vidyalaya, Railway Colony Tughlakabad South , New Delhi",1,1,0,1,0,0,0,0
2693,101-HYDERABAD,M38359-Mannu Model School,1,1,1,0,1,0,100,100
2694,114-DEHRADUN,340283-The Oxford School,1,1,1,0,1,0,100,100
2695,120-RANCHI,260131-Govt. +2 High School,1,1,0,1,0,0,0,0
2696,104-GUWAHATI,130021-Nongthymmai Nepali Higher Sec.,1,1,1,0,1,0,100,100
2697,104-GUWAHATI,M02065-CENTRAL PUBLIC SCHOOL,1,1,1,0,1,0,100,100
2698,111-ALLAHABAD/PRAYAGRAJ,210699-Karam Devi Memorial Academy,1,1,1,0,1,0,100,100
2699,120-RANCHI,260202-RADHA GOVIND PUBLIC SCHOOL,1,1,1,0,1,0,100,100
2700,115-BHUBANESWAR,410086-Govt. High School,1,1,1,0,1,0,100,100
2701,101-HYDERABAD,M01198-Insight International School,1,1,1,0,1,0,100,100
2702,119-RAIPUR,290046-Kendriya Vidyalaya,1,1,1,0,1,0,100,100
2703,113-BHOPAL,100191-Narsingh Public Hr. Sec. School,1,1,0,1,0,0,0,0
2704,114-DEHRADUN,450107-Deaf & Dumb School,1,1,1,0,1,0,100,100
2705,107-DELHI,"G27017-GOVT. BOYS SENIOR SEC. SCHOOL, D-BLOCK, NEAR GURUDWARA, PRASHANT VIHAR, DELHI-85",1,1,0,1,0,0,0,0
2706,110-PATNA,030065-Mangal Seminary Inter College,1,1,1,0,0,1,100,0
2707,125-JAMMU,070063-Army Public School,1,1,1,0,1,0,100,100
2708,117-BENGALURU,080068-Jindal Vidya Mandir,1,1,1,0,1,0,100,100
2709,119-RAIPUR,290105-Govt. Higher Secondary School,1,1,1,0,1,0,100,100
2710,107-DELHI,270261-Rajdhani Public School,1,1,0,1,0,0,0,0
2711,121-CHENNAI,420051-Kittappa Mpl. Hr. Sec. School,1,1,0,1,0,0,0,0
2712,111-ALLAHABAD/PRAYAGRAJ,M21578-St. Joseph's Convent School,1,1,1,0,1,0,100,100
2713,120-RANCHI,260128-R.k.+2 School,1,1,0,1,0,0,0,0
2714,111-ALLAHABAD/PRAYAGRAJ,210692-Mahatma J.f. Public School,1,1,1,0,1,0,100,100
2715,104-GUWAHATI,140010-Ibaung Thou Memorial High School,1,1,1,0,0,1,100,0
2716,110-PATNA,M03400-Angel High School,1,1,1,0,0,1,100,0
2717,119-RAIPUR,290028-Maharishi Vidya Mandir-i,1,1,1,0,1,0,100,100
2718,109-JAIPUR,170225-Jawahar Navodaya Vidyalaya,1,1,0,1,0,0,0,0
2719,107-DELHI,M38351-Khadijatul Kubra Girls Public Sch.,1,1,1,0,1,0,100,100
2720,106-KOCHI,M09074-Quadisiyya English Medium Madarsa,1,1,1,0,1,0,100,100
2721,105-CHANDIGARH,050384-Apex Public School,1,1,1,0,1,0,100,100
2722,107-DELHI,270439-Govt. Boys Senior Secondary School,1,1,0,1,0,0,0,0
2723,114-DEHRADUN,340176-Vidya Vikasinee Inter College,1,1,1,0,0,1,100,0
2724,107-DELHI,"G27057-Govt.Girls Sr.Sec.School, No-2 A-Block Janak Puri New West-B, Delhi-110058",1,1,0,1,0,0,0,0
2725,107-DELHI,"G27002-SARVODAYA CO-ED SEC. SCHOOL, I.P. EXT. PATPAR GANJ,DELHI-110092",1,1,0,1,0,0,0,0
2726,113-BHOPAL,100119-Kendriya Vidyalaya No-1,1,1,1,0,0,1,100,0
2727,111-ALLAHABAD/PRAYAGRAJ,210433-Jawahar Navodaya Vidyalaya,1,1,0,1,0,0,0,0
2728,107-DELHI,270286-Gyan Sagar Public School,1,1,0,1,0,0,0,0
2729,105-CHANDIGARH,050633-Shree Maharaja Aggarsain Public School,1,1,1,0,1,0,100,100
2730,120-RANCHI,260004-Sacred Heart Convent School,1,1,1,0,0,1,100,0
2731,107-DELHI,050411-Universal Senior Secondary School,1,1,0,1,0,0,0,0
2732,110-PATNA,030402-Lohia Nagar Mount Carmel High,1,1,1,0,1,0,100,100
2733,107-DELHI,"G27050-Govt.Girls Sr.School, Bc-Block Sultan Puri, North West, Delhi-110086",1,1,0,1,0,0,0,0
2734,107-DELHI,270281-Shaheed Bishan S.memo.sr.sec.school,1,1,0,1,0,0,0,0
2735,109-JAIPUR,170315-Ajay Shikshan Sansthan Sr.sec.schol,1,1,0,1,0,0,0,0
2736,114-DEHRADUN,210227-H.s.aggarwal Inter College,1,1,1,0,0,1,100,0
2737,105-CHANDIGARH,050087-Arya Sr.sec School,1,1,1,0,1,0,100,100
2738,107-DELHI,210709-L.K. International School,1,1,1,0,1,0,100,100
2739,103-KOLKATA,450043-Raphael Academic & Voc. School,1,1,1,0,0,1,100,0
2740,105-CHANDIGARH,250006-Bal Niketan Model Sr.sec.school,1,1,1,0,0,1,100,0
2741,105-CHANDIGARH,M16097-Holy Mary's School,1,1,1,0,1,0,100,100
2742,119-RAIPUR,290073-Jawahar Navodaya Vidyalaya,1,1,1,0,0,1,100,0
2743,121-CHENNAI,190071-Govt. Boys Hr.sec. School,1,1,1,0,1,0,100,100
2744,110-PATNA,030390-Jeewan Public School,1,1,1,0,0,1,100,0
2745,122-DHARAMSALA,060029-Govt. Senior Secondary School,1,1,0,1,0,0,0,0
